Flow id,Src IP,Dst IP,Dst port,Protocol,Application protocol,Duration,Received bytes,Received packets,Transmitted bytes,Transmitted packets,Total bytes,Total packets,label,family
1802690760480960768,fe80:0000:0000:0000:8fc8:b416:45a8:93c4,ff02:0000:0000:0000:0000:0000:0000:00fb,5353,udp,-,0,0,0,2030,10,2030,10,normal,-
3478564910713000151,10.0.2.15,224.0.0.251,5353,udp,-,0,0,0,915,5,915,5,normal,-
7144567303292606061,10.0.2.15,142.251.37.99,443,tcp,-,48,60,1,128,2,188,3,normal,-
-1288847950797670904,10.0.2.15,142.251.37.99,443,tcp,-,41,60,1,128,2,188,3,normal,-
-801552549855807669,104.17.50.95,10.0.2.15,49651,udp,-,0,105,1,610,2,715,3,normal,-
-4906931177106038448,10.0.2.15,142.251.36.97,443,tcp,tls,355,9717,14,1622,15,11339,29,normal,-
-8005082079628227372,10.0.2.15,142.251.36.134,443,tcp,tls,512,6715,17,2142,18,8857,35,normal,-
-4203017584352728617,104.17.50.95,10.0.2.15,36214,udp,-,0,105,1,610,2,715,3,normal,-
8157211447716375078,10.0.2.15,142.251.36.78,443,tcp,tls,500,7132,22,2751,20,9883,42,normal,-
9168702843582306234,10.0.2.15,142.251.36.78,443,tcp,tls,185,7284,9,1077,10,8361,19,normal,-
3139407622609568201,10.0.2.15,52.152.143.207,443,tcp,tls,20293,10142,33,14132,33,24274,66,normal,-
3122691582259859865,10.0.2.15,52.208.34.114,443,tcp,tls,326,6634,14,1644,14,8278,28,normal,-
-3276271235963803422,10.0.2.15,216.239.32.36,443,tcp,tls,361,6720,19,2394,18,9114,37,normal,-
7527069500659646533,10.0.2.15,104.64.171.144,443,tcp,tls,42558,14024,24,6730,22,20754,46,normal,-
551161735232755316,10.0.2.15,199.59.243.223,80,tcp,http,353,775,6,1288,7,2063,13,normal,-
-7999693271106936615,10.0.2.15,199.59.243.223,80,tcp,http,3555,27800,29,6564,29,34364,58,normal,-
8831161535150351564,10.0.2.15,142.251.36.106,443,tcp,tls,877,8225,20,2257,19,10482,39,normal,-
4110462709517201524,10.0.2.15,52.205.78.47,443,tcp,tls,44106,7021,20,2775,20,9796,40,normal,-
-7930361718147970592,10.0.2.15,23.195.248.26,443,tcp,tls,64973,149725,117,6405,96,156130,213,normal,-
7693580259579155287,10.0.2.15,104.64.171.144,443,tcp,tls,5901,711,9,1190,9,1901,18,normal,-
5102748965749421193,10.0.2.15,192.0.77.2,443,tcp,tls,7852,274676,199,6797,102,281473,301,normal,-
2783178178055749480,10.0.2.15,13.107.238.45,443,tcp,tls,47959,5746,16,2804,16,8550,32,normal,-
696718883778153625,10.0.2.15,95.100.146.82,443,tcp,tls,20207,6519,17,2009,16,8528,33,normal,-
-2434237490984854335,10.0.2.15,142.251.37.110,443,tcp,tls,203,8156,13,1514,13,9670,26,normal,-
-6483289653797853399,10.0.2.15,23.195.248.26,443,tcp,tls,757,8996,16,1692,16,10688,32,normal,-
5295428368248458058,10.0.2.15,23.195.248.26,443,tcp,tls,1026,8996,16,1692,16,10688,32,normal,-
4088896642581942537,10.0.2.15,52.35.213.102,443,tcp,tls,44972,7956,19,2517,18,10473,37,normal,-
4157184846524060492,10.0.2.15,192.0.76.3,443,tcp,tls,8010,8959,21,2281,18,11240,39,normal,-
1317018818618866824,10.0.2.15,23.195.248.219,443,tcp,tls,65578,3237081,2264,39241,593,3276322,2857,normal,-
-1044563883296858672,10.0.2.15,68.219.88.97,443,tcp,tls,139,1654,4,807,5,2461,9,normal,-
-8905861264425357953,10.0.2.15,157.240.30.35,443,tcp,tls,204,4481,13,1460,12,5941,25,normal,-
-922773594858788038,10.0.2.15,63.33.154.254,443,tcp,tls,44762,9090,19,2181,18,11271,37,normal,-
3665074015234942899,10.0.2.15,142.251.36.78,443,tcp,tls,141,3268,6,861,6,4129,12,normal,-
1839913573329117255,10.0.2.15,40.126.32.133,443,tcp,tls,45899,26696,31,4798,26,31494,57,normal,-
-4596487858783417795,10.0.2.15,142.251.36.78,443,tcp,tls,199,8216,14,1514,13,9730,27,normal,-
1439158360227955097,10.0.2.15,199.59.243.223,80,tcp,http,1365,27077,26,3491,26,30568,52,normal,-
628054872152278788,10.0.2.15,2.16.2.193,443,tcp,tls,47737,5906,18,2006,16,7912,34,normal,-
-7297345984715708760,10.0.2.15,95.100.146.24,443,tcp,tls,224,6128,12,1476,12,7604,24,normal,-
2925130970753682848,10.0.2.15,152.199.19.160,443,tcp,tls,42878,28985,35,2496,25,31481,60,normal,-
2109800560032773364,10.0.2.15,198.143.164.252,443,tcp,tls,8569,263000,234,12534,139,275534,373,normal,-
5106397642513236203,10.0.2.15,142.251.36.97,443,tcp,tls,313,9724,14,1622,15,11346,29,normal,-
-6469163575003071223,10.0.2.15,23.195.248.26,443,tcp,tls,1117,8996,16,1692,16,10688,32,normal,-
7816360034568461489,10.0.2.15,142.251.36.142,443,tcp,tls,357,5585,11,1460,12,7045,23,normal,-
-7240621931762885871,10.0.2.15,157.240.30.35,443,tcp,tls,193,4421,12,1406,11,5827,23,normal,-
3064059719856341533,10.0.2.15,142.251.37.100,443,tcp,tls,1200,49168,44,3701,27,52869,71,normal,-
1484727346420390060,10.0.2.15,142.251.36.141,443,tcp,tls,264,7329,18,2233,16,9562,34,normal,-
4285445070071231959,10.0.2.15,142.251.37.110,443,tcp,tls,357,11362,24,2569,21,13931,45,normal,-
-2144715020927740115,10.0.2.15,142.251.36.98,443,tcp,tls,435,8985,19,3240,19,12225,38,normal,-
-7197499056674061835,10.0.2.15,157.240.253.60,443,tcp,tls,454,7667,20,2189,19,9856,39,normal,-
-2323405026376290187,10.0.2.15,142.251.37.100,443,tcp,tls,902,5568,11,1406,11,6974,22,normal,-
-4171165069205394429,10.0.2.15,147.67.34.45,443,tcp,tls,16871,4613,11,1664,12,6277,23,normal,-
-8098591574828163294,10.0.2.15,142.251.36.97,443,tcp,tls,423,9723,14,1622,15,11345,29,normal,-
-6539998073493478636,10.0.2.15,13.89.178.27,443,tcp,tls,45392,16432,109,90699,108,107131,217,normal,-
587893264937701772,10.0.2.15,142.251.37.98,443,tcp,tls,78900,6427,18,2189,17,8616,35,normal,-
-8494592774836708306,10.0.2.15,52.209.101.131,443,tcp,tls,44676,9195,19,2796,18,11991,37,normal,-
3643923829233653483,10.0.2.15,142.251.36.97,443,tcp,tls,480,34824,53,4378,40,39202,93,normal,-
5834912951597022349,10.0.2.15,13.107.42.14,443,tcp,tls,45565,6925,19,2593,19,9518,38,normal,-
-435504752346703491,10.0.2.15,142.251.36.77,443,tcp,tls,788,10858,23,3353,21,14211,44,normal,-
773467781332417066,10.0.2.15,95.100.146.24,443,tcp,tls,288,6272,14,1530,13,7802,27,normal,-
-6619782579056466340,10.0.2.15,142.251.36.65,443,tcp,tls,334,11384,22,2413,20,13797,42,normal,-
4282844112763155188,10.0.2.15,13.107.238.44,443,tcp,tls,45430,30921,37,3128,28,34049,65,normal,-
1453662013435901438,10.0.2.15,23.195.249.173,443,tcp,tls,545,7710,15,1584,14,9294,29,normal,-
-5007637191205891799,10.0.2.15,65.9.9.67,443,tcp,tls,16777,15595,25,2265,21,17860,46,normal,-
5252312132266511400,10.0.2.15,95.100.146.24,443,tcp,tls,47457,353159,326,26132,253,379291,579,normal,-
5218652450424813759,10.0.2.15,142.251.36.150,443,tcp,tls,673,6590,18,2128,18,8718,36,normal,-
9153853060892487129,10.0.2.15,13.107.21.200,443,tcp,tls,90,1654,4,807,5,2461,9,normal,-
9182246885081182108,10.0.2.15,142.251.36.98,443,tcp,tls,253,6968,18,2088,16,9056,34,normal,-
6853557694835757347,10.0.2.15,198.143.164.252,443,tcp,tls,100686,6815,17,2032,16,8847,33,normal,-
1911733043134987919,10.0.2.15,13.107.21.200,443,tcp,tls,45545,26532,47,6009,39,32541,86,normal,-
-8839760144976267471,10.0.2.15,142.251.37.106,443,tcp,tls,249,2264,14,2254,14,4518,28,normal,-
-6661842977502108088,10.0.2.15,192.0.77.2,443,tcp,tls,609,5094,12,1460,12,6554,24,normal,-
-669097606821469815,10.0.2.15,142.251.37.100,443,tcp,tls,235,21378,27,2199,19,23577,46,normal,-
-8883918801434980214,10.0.2.15,142.251.37.99,443,tcp,tls,290,6534,18,2175,16,8709,34,normal,-
-7911818450378508594,10.0.2.15,13.107.238.44,443,tcp,tls,46734,60371,55,3027,30,63398,85,normal,-
4648876369037383199,10.0.2.15,23.195.248.26,443,tcp,tls,64311,208605,155,5865,86,214470,241,normal,-
3598529511506111608,10.0.2.15,142.251.37.100,443,tcp,tls,327,6602,17,2132,16,8734,33,normal,-
2274641867906954,10.0.2.15,104.64.171.144,443,tcp,tls,6941,7069,14,1524,15,8593,29,normal,-
-928866900704906155,10.0.2.15,151.101.193.192,443,tcp,tls,37520,49075,46,2807,28,51882,74,normal,-
-1259859869911704859,10.0.2.15,192.0.76.3,443,tcp,tls,498,5038,11,1460,12,6498,23,normal,-
2236394347526888392,10.0.2.15,23.195.248.244,443,tcp,tls,197,6677,15,1584,14,8261,29,normal,-
-8719524036621215394,10.0.2.15,91.198.174.192,443,tcp,tls,100823,7863,22,2212,19,10075,41,normal,-
5837590220533932056,10.0.2.15,142.251.36.142,443,tcp,tls,84795,9720,21,2311,20,12031,41,normal,-
-5454146346911885100,10.0.2.15,13.107.238.45,443,tcp,tls,46492,7256,15,1797,15,9053,30,normal,-
6672383383455747921,10.0.2.15,34.231.64.174,443,tcp,tls,47947,6574,15,1819,16,8393,31,normal,-
-3180650368908876959,10.0.2.15,23.195.248.244,443,tcp,tls,42223,106501,110,6735,72,113236,182,normal,-
-2393059514173455547,10.0.2.15,142.251.36.142,443,tcp,tls,1200,8162,13,1514,13,9676,26,normal,-
2219745916825547379,10.0.2.15,142.251.36.78,443,tcp,tls,106,3148,6,861,6,4009,12,normal,-
-5242919292908458407,10.0.2.15,142.251.36.142,443,tcp,tls,2122,9353,18,3250,18,12603,36,normal,-
-4593527672410772373,10.0.2.15,157.240.30.35,443,tcp,tls,255,5614,25,2625,20,8239,45,normal,-
6164753153020806043,10.0.2.15,142.251.36.72,443,tcp,tls,279,47696,46,2647,28,50343,74,normal,-
-6106437751148156662,10.0.2.15,142.251.36.131,443,tcp,tls,1099,78361,68,3238,32,81599,100,normal,-
-5179469961899210221,10.0.2.15,34.250.135.14,443,tcp,tls,44423,7216,18,2177,19,9393,37,normal,-
982390295731745840,10.0.2.15,142.251.37.99,443,tcp,tls,102,3268,6,861,6,4129,12,normal,-
1115433253254149470,10.0.2.15,35.186.249.72,443,tcp,tls,919,22535,29,2807,30,25342,59,normal,-
4656431344307830399,10.0.2.15,68.219.88.97,443,tcp,tls,45287,9910,28,6438,26,16348,54,normal,-
-5218679345445216012,10.0.2.15,104.64.171.144,443,tcp,tls,42558,13371,22,4191,20,17562,42,normal,-
-1874946883666880192,10.0.2.15,142.251.36.138,443,tcp,tls,212,6018,12,1460,12,7478,24,normal,-
6443220365834063498,10.0.2.15,142.251.36.131,443,tcp,tls,523,5601,11,1406,11,7007,22,normal,-
9112667645592478784,10.0.2.15,200.147.35.149,443,tcp,tls,14612,4522,12,2001,12,6523,24,normal,-
1714826773905208730,10.0.2.15,52.209.101.131,443,tcp,tls,45484,8581,21,2413,19,10994,40,normal,-
-427596763189738455,10.0.2.15,95.100.146.41,80,tcp,http,16361,1183,5,767,6,1950,11,normal,-
-9199797115499727933,10.0.2.15,52.167.30.171,443,tcp,tls,46444,39292,46,5754,31,45046,77,normal,-
2990311826635158094,10.0.2.15,23.195.248.26,443,tcp,tls,1103,8996,16,1638,15,10634,31,normal,-
7665246906691894813,10.0.2.15,23.195.248.26,443,tcp,tls,64305,624529,442,22920,400,647449,842,normal,-
-5754510151658602597,10.0.2.15,52.208.34.114,443,tcp,tls,42028,7685,20,3449,21,11134,41,normal,-
-5708531357313687002,10.0.2.15,23.195.249.173,443,tcp,tls,290,7566,13,1530,13,9096,26,normal,-
7469156177569252428,10.0.2.15,23.195.248.26,443,tcp,tls,65217,686615,483,14218,237,700833,720,normal,-
-4405893512693366059,10.0.2.15,23.195.249.173,443,tcp,tls,47235,219357,171,8800,129,228157,300,normal,-
1171917040582752344,10.0.2.15,2.16.2.194,443,tcp,tls,47406,12324,24,2405,19,14729,43,normal,-
650756039752389413,10.0.2.15,13.107.238.45,443,tcp,tls,37146,60721,53,2842,29,63563,82,normal,-
-889149271336295745,10.0.2.15,142.251.37.100,443,tcp,tls,338,65214,57,2822,28,68036,85,normal,-
-2564910295832855537,10.0.2.15,104.64.171.144,443,tcp,tls,42558,10426,20,4137,19,14563,39,normal,-
-1539626704158196800,10.0.2.15,157.240.30.35,443,tcp,tls,203,4363,11,1406,11,5769,22,normal,-
6425845761959295141,10.0.2.15,65.9.95.91,443,tcp,tls,13605,7640,17,2102,18,9742,35,normal,-
3427228044662503821,10.0.2.15,142.251.36.78,443,tcp,tls,973,1845730,1283,25607,402,1871337,1685,normal,-
2040436903049346926,10.0.2.15,13.89.178.27,443,tcp,tls,45392,8273,22,3092,21,11365,43,normal,-
-2009415203357706960,10.0.2.15,142.251.36.130,443,tcp,tls,293,6852,19,2106,17,8958,36,normal,-
538690999044133882,10.0.2.15,65.9.95.76,443,tcp,tls,44523,113475,101,5505,62,118980,163,normal,-
-6608299349900990494,10.0.2.15,192.229.221.185,443,tcp,tls,44788,15943,25,2273,20,18216,45,normal,-
5271395687154165754,10.0.2.15,178.249.97.98,443,tcp,tls,36675,21185,29,2830,27,24015,56,normal,-
-1511748087776727296,10.0.2.15,142.251.36.72,443,tcp,tls,590,67749,58,2916,33,70665,91,normal,-
8843347304334435878,10.0.2.15,44.235.246.155,443,tcp,tls,17100,6250,17,2061,17,8311,34,normal,-
-2524353704145876874,10.0.2.15,13.107.238.44,443,tcp,tls,47954,32797,40,3784,35,36581,75,normal,-
3628681944680483143,10.0.2.15,142.251.36.138,443,tcp,tls,576,41933,54,5198,37,47131,91,normal,-
-6599212000904688438,10.0.2.15,142.251.36.106,443,tcp,tls,488,6071,13,1568,14,7639,27,normal,-
-7904229377226960996,10.0.2.15,13.107.21.200,443,tcp,tls,161,1654,4,807,5,2461,9,normal,-
-5172900258245196062,10.0.2.15,142.251.36.106,443,tcp,tls,244,2486,12,2201,13,4687,25,normal,-
-405566859356231013,10.0.2.15,23.195.248.26,443,tcp,tls,64889,633021,447,21625,376,654646,823,normal,-
3080015759190750960,10.0.2.15,142.251.36.65,443,tcp,tls,178,9717,14,1568,14,11285,28,normal,-
-7423233569002999296,10.0.2.15,8.8.8.8,53,udp,dns,48,148,1,92,1,240,2,normal,-
7994254881876424648,10.0.2.15,8.8.8.8,53,udp,dns,50,155,1,94,1,249,2,normal,-
-8042866546955774614,10.0.2.15,34.208.115.43,443,tcp,-,34751,3602,21,8526,20,12128,41,normal,-
-7460997455809199611,10.0.2.15,8.8.8.8,53,udp,dns,51,211,1,91,1,302,2,normal,-
8872177082154755166,10.0.2.15,8.8.8.8,53,udp,dns,52,157,1,84,1,241,2,normal,-
-837855295150498953,10.0.2.15,8.8.8.8,53,udp,dns,72,141,1,84,1,225,2,normal,-
-8165527461622505656,10.0.2.15,142.251.36.78,443,udp,-,254,9821,12,2669,13,12490,25,normal,-
4126372917227569003,10.0.2.15,8.8.8.8,53,udp,dns,70,170,1,88,1,258,2,normal,-
773611384649521942,10.0.2.15,8.8.8.8,53,udp,dns,59,114,1,98,1,212,2,normal,-
-8009621696271552134,10.0.2.15,8.8.8.8,53,udp,dns,55,132,1,87,1,219,2,normal,-
6229540636295792105,10.0.2.15,172.64.155.188,80,tcp,http,45178,2519,10,1461,11,3980,21,normal,-
-3167226588084764070,10.0.2.15,104.18.25.196,443,tcp,-,95314,604,8,660,8,1264,16,normal,-
4403064527930283258,10.0.2.15,142.251.37.99,443,udp,-,157,2290,4,1703,4,3993,8,normal,-
208775142398296109,10.0.2.15,8.8.8.8,53,udp,dns,55,141,1,82,1,223,2,normal,-
1866130987575220574,10.0.2.15,95.100.146.41,80,tcp,-,74720,600,10,540,10,1140,20,normal,-
-2440986919527560011,10.0.2.15,8.8.8.8,53,udp,dns,57,111,1,95,1,206,2,normal,-
5625220317794753485,10.0.2.15,8.8.8.8,53,udp,dns,48,233,1,101,1,334,2,normal,-
-4996227578181133632,10.0.2.15,142.251.37.100,443,udp,-,268,2290,4,1628,3,3918,7,normal,-
-2640145166660777825,10.0.2.15,8.8.8.8,53,udp,dns,107,306,2,174,2,480,4,normal,-
-3884544401471295920,10.0.2.15,8.8.8.8,53,udp,dns,42,325,1,87,1,412,2,normal,-
-4827628045460418560,10.0.2.15,8.8.8.8,53,udp,dns,60,220,1,99,1,319,2,normal,-
-2367260318959429634,10.0.2.15,8.8.8.8,53,udp,dns,62,258,1,84,1,342,2,normal,-
-7247451303655262993,10.0.2.15,8.8.8.8,53,udp,dns,60,169,1,87,1,256,2,normal,-
6855102112202187837,10.0.2.15,8.8.8.8,53,udp,dns,86,136,1,80,1,216,2,normal,-
-3781795627085167869,10.0.2.15,199.59.243.223,80,tcp,http,20699,1310,8,2009,9,3319,17,normal,-
-4190049535581500467,10.0.2.15,8.8.8.8,53,udp,dns,74,282,1,84,1,366,2,normal,-
2165427629726166636,10.0.2.15,8.8.8.8,53,udp,dns,98,145,1,83,1,228,2,normal,-
1902137415833811400,10.0.2.15,8.8.8.8,53,udp,dns,73,141,1,82,1,223,2,normal,-
-5842271032142229705,10.0.2.15,8.8.8.8,53,udp,dns,63,177,1,89,1,266,2,normal,-
-1394892198251914777,10.0.2.15,142.251.36.131,443,tcp,-,56,60,1,128,2,188,3,normal,-
-4697580881104237342,10.0.2.15,8.8.8.8,53,udp,dns,83,248,1,92,1,340,2,normal,-
-3169324161071182515,10.0.2.15,8.8.8.8,53,udp,dns,61,132,1,116,1,248,2,normal,-
2719781592405512720,10.0.2.15,8.8.8.8,53,udp,dns,210,445,2,198,2,643,4,normal,-
7193544735267848416,10.0.2.15,142.251.37.100,443,udp,-,2411,431740,347,31605,95,463345,442,normal,-
6279476956245025768,10.0.2.15,8.8.8.8,53,udp,dns,60,97,1,81,1,178,2,normal,-
1870640322916136275,10.0.2.15,8.8.8.8,53,udp,dns,61,141,1,84,1,225,2,normal,-
-5816781180421426690,10.0.2.15,65.9.95.102,443,tcp,-,78339,500,7,547,7,1047,14,normal,-
-8487057603357151963,10.0.2.15,8.8.8.8,53,udp,dns,33,116,1,84,1,200,2,normal,-
-6503886729366302020,10.0.2.15,8.8.8.8,53,udp,dns,89,149,1,93,1,242,2,normal,-
2521484380085782903,10.0.2.15,34.117.65.55,443,tcp,-,587,378,6,322,5,700,11,normal,-
8518197249943098391,10.0.2.15,8.8.8.8,53,udp,dns,45,118,1,90,1,208,2,normal,-
-360833690934337872,10.0.2.15,8.8.8.8,53,udp,dns,218,190,1,85,1,275,2,normal,-
-8991583095389678145,10.0.2.15,8.8.8.8,53,udp,dns,79,135,1,86,1,221,2,normal,-
-3353560604192731465,10.0.2.15,34.107.204.85,443,udp,-,969,4197,3,3169,4,7366,7,normal,-
7687847514570727366,10.0.2.15,8.8.8.8,53,udp,dns,52,97,1,81,1,178,2,normal,-
-1865000941003454089,10.0.2.15,8.8.8.8,53,udp,dns,52,228,1,104,1,332,2,normal,-
9154485139421305442,10.0.2.15,65.9.94.185,443,tcp,-,90,60,1,128,2,188,3,normal,-
8752466168741379839,10.0.2.15,8.8.8.8,53,udp,dns,63,251,1,88,1,339,2,normal,-
8306089279242930731,10.0.2.15,8.8.8.8,53,udp,dns,96,239,1,91,1,330,2,normal,-
-5929873102200688768,10.0.2.15,142.251.36.67,80,tcp,-,5795,180,3,236,4,416,7,normal,-
1823542460313932065,10.0.2.15,8.8.8.8,53,udp,dns,59,196,1,93,1,289,2,normal,-
4507251089980654395,10.0.2.15,142.251.36.138,443,udp,-,256,7388,8,1983,7,9371,15,normal,-
6276709606914554744,10.0.2.15,142.251.36.131,443,tcp,-,39,60,1,128,2,188,3,normal,-
-1782438740314063125,10.0.2.15,8.8.8.8,53,udp,dns,52,178,1,97,1,275,2,normal,-
8977725071234273642,10.0.2.15,8.8.8.8,53,udp,dns,86,102,1,86,1,188,2,normal,-
-7467183632966512315,10.0.2.15,65.9.94.185,443,tcp,-,193,60,1,128,2,188,3,normal,-
4953322699577473946,10.0.2.15,8.8.8.8,53,udp,dns,60,244,1,99,1,343,2,normal,-
-6815249952862917499,10.0.2.15,8.8.8.8,53,udp,dns,52,170,1,88,1,258,2,normal,-
480208070860373173,10.0.2.15,8.8.8.8,53,udp,dns,65,179,1,114,1,293,2,normal,-
-5765354144761431018,10.0.2.15,8.8.8.8,53,udp,dns,58,180,1,114,1,294,2,normal,-
-3043864413846681656,10.0.2.15,17.253.73.203,80,tcp,http,63726,2206,12,1163,13,3369,25,normal,-
-4438897195937694436,10.0.2.15,8.8.8.8,53,udp,dns,50,233,1,101,1,334,2,normal,-
-1076553643922901183,10.0.2.15,8.8.8.8,53,udp,dns,132,115,1,87,1,202,2,normal,-
-7064448187310466633,10.0.2.15,8.8.8.8,53,udp,dns,61,162,1,82,1,244,2,normal,-
-416514295530159941,10.0.2.15,142.251.36.130,443,udp,-,303,3286,8,2027,5,5313,13,normal,-
-6298337805140580435,10.0.2.15,157.240.30.35,443,udp,-,13309,1992,20,13261,20,15253,40,normal,-
-2722206822651868039,10.0.2.15,8.8.8.8,53,udp,dns,37,150,1,90,1,240,2,normal,-
112786109801643481,10.0.2.15,8.8.8.8,53,udp,dns,70,106,1,90,1,196,2,normal,-
-817285005149656243,10.0.2.15,8.8.8.8,53,udp,dns,44,100,1,84,1,184,2,normal,-
-7682521523842683721,10.0.2.15,142.251.36.142,443,udp,-,288,9733,11,2448,11,12181,22,normal,-
7932334262750710705,10.0.2.15,65.9.94.185,443,tcp,-,83,60,1,128,2,188,3,normal,-
2332475460317207019,10.0.2.15,8.8.8.8,53,udp,dns,54,144,1,87,1,231,2,normal,-
-5625520005743018836,10.0.2.15,8.8.8.8,53,udp,dns,470,109,1,81,1,190,2,normal,-
-2820782004375068755,10.0.2.15,8.8.8.8,53,udp,dns,43,106,1,90,1,196,2,normal,-
-6191479946070749058,10.0.2.15,142.251.36.138,443,udp,-,334,7478,9,2444,11,9922,20,normal,-
-7640308890995923139,10.0.2.15,8.8.8.8,53,udp,dns,66,178,1,93,1,271,2,normal,-
8423189812362930058,10.0.2.15,8.8.8.8,53,udp,dns,70,187,1,116,1,303,2,normal,-
-6550224390067826294,10.0.2.15,8.8.8.8,53,udp,dns,57,130,1,82,1,212,2,normal,-
4855958290997925430,10.0.2.15,8.8.8.8,53,udp,dns,47,172,1,91,1,263,2,normal,-
4588949194142644658,10.0.2.15,8.8.8.8,53,udp,dns,39,104,1,88,1,192,2,normal,-
-638702576664638765,10.0.2.15,65.9.95.31,443,tcp,-,95995,633,10,856,10,1489,20,normal,-
8803131845694831166,10.0.2.15,142.251.37.99,443,tcp,-,48,60,1,128,2,188,3,normal,-
7580886203337345303,10.0.2.15,142.251.36.141,443,udp,-,141,2290,4,1628,3,3918,7,normal,-
2474723759901295036,10.0.2.15,8.8.8.8,53,udp,dns,41,187,1,83,1,270,2,normal,-
-1405180243696539639,10.0.2.15,23.195.249.173,443,tcp,-,61702,684,10,627,9,1311,19,normal,-
7431720442150786190,10.0.2.15,34.160.144.191,443,tcp,-,72547,500,7,547,7,1047,14,normal,-
-5121384707105846653,10.0.2.15,8.8.8.8,53,udp,dns,35,156,1,92,1,248,2,normal,-
4574261812406511398,10.0.2.15,142.251.37.110,443,udp,-,190,9636,10,2071,8,11707,18,normal,-
-4114884434993757336,10.0.2.15,8.8.8.8,53,udp,dns,52,112,1,96,1,208,2,normal,-
-4262892288001113872,10.0.2.15,142.251.36.131,443,udp,-,764,6967,7,2074,8,9041,15,normal,-
-5712548163379761461,10.0.2.15,8.8.8.8,53,udp,dns,53,279,1,87,1,366,2,normal,-
9039624335463515355,10.0.2.15,216.239.32.36,443,udp,-,4410,7887,13,2748,11,10635,24,normal,-
820739467727240070,10.0.2.15,8.8.8.8,53,udp,dns,96,363,1,91,1,454,2,normal,-
-4498254929258923030,10.0.2.15,142.251.36.67,80,tcp,-,5796,180,3,236,4,416,7,normal,-
-7153176016523818120,10.0.2.15,8.8.8.8,53,udp,dns,136,239,1,91,1,330,2,normal,-
1972145133439016241,10.0.2.15,8.8.8.8,53,udp,dns,75,215,1,86,1,301,2,normal,-
5204833399901277009,10.0.2.15,34.117.65.55,443,tcp,-,79104,546,8,573,8,1119,16,normal,-
1850638493275286680,10.0.2.15,8.8.8.8,53,udp,dns,57,137,1,93,1,230,2,normal,-
-3164243030041614902,10.0.2.15,8.8.8.8,53,udp,dns,58,205,1,90,1,295,2,normal,-
5211490916510013437,10.0.2.15,8.8.8.8,53,udp,dns,53,189,1,118,1,307,2,normal,-
-277058289478039903,10.0.2.15,8.8.8.8,53,udp,dns,76,272,1,90,1,362,2,normal,-
-3367567084123768409,10.0.2.15,142.251.36.106,443,udp,-,9037,9978,18,2950,14,12928,32,normal,-
1760716384164991912,10.0.2.15,8.8.8.8,53,udp,dns,44,141,1,96,1,237,2,normal,-
6498358713546447630,10.0.2.15,8.8.8.8,53,udp,dns,257,247,2,174,2,421,4,normal,-
7885213913828053102,10.0.2.15,8.8.8.8,53,udp,dns,78,143,1,75,1,218,2,normal,-
7060979815987061186,10.0.2.15,8.8.8.8,53,udp,dns,89,125,1,93,1,218,2,normal,-
-1716332370076728888,10.0.2.15,8.8.8.8,53,udp,dns,72,212,1,83,1,295,2,normal,-
3400075567200580874,10.0.2.15,8.8.8.8,53,udp,dns,55,336,1,91,1,427,2,normal,-
-4274167479608709086,10.0.2.15,216.239.34.36,443,udp,-,975,4923,5,2676,4,7599,9,normal,-
9184894078196738319,10.0.2.15,8.8.8.8,53,udp,dns,263,137,1,81,1,218,2,normal,-
840248045909167561,10.0.2.15,104.19.155.83,443,udp,-,1183,7670,11,4629,7,12299,18,normal,-
-3081827583309771895,10.0.2.15,152.199.19.161,443,tcp,-,53,60,1,128,2,188,3,normal,-
3985634576096151537,10.0.2.15,8.8.8.8,53,udp,dns,62,112,1,96,1,208,2,normal,-
-7862554091883833132,10.0.2.15,8.8.8.8,53,udp,dns,47,99,1,83,1,182,2,normal,-
-8586810179256867930,10.0.2.15,142.251.36.131,80,tcp,-,96582,5556,23,3804,23,9360,46,normal,-
-728578779373832970,10.0.2.15,8.8.8.8,53,udp,dns,64,100,1,84,1,184,2,normal,-
6516591094934585182,10.0.2.15,8.8.8.8,53,udp,dns,50,115,1,87,1,202,2,normal,-
1393443470405997292,10.0.2.15,8.8.8.8,53,udp,dns,98,99,1,83,1,182,2,normal,-
-5348619181289884839,10.0.2.15,8.8.8.8,53,udp,dns,66,180,1,118,1,298,2,normal,-
-1037874909548961370,10.0.2.15,8.8.8.8,53,udp,dns,50,103,1,87,1,190,2,normal,-
-2814490100201848942,10.0.2.15,8.8.8.8,53,udp,dns,79,187,1,100,1,287,2,normal,-
6318306829438858734,10.0.2.15,8.8.8.8,53,udp,dns,42,152,1,90,1,242,2,normal,-
-5038484455499987618,10.0.2.15,8.8.8.8,53,udp,dns,104,239,1,91,1,330,2,normal,-
-7926996690111288100,10.0.2.15,8.8.8.8,53,udp,dns,65,106,1,90,1,196,2,normal,-
3094406798358035314,10.0.2.15,8.8.8.8,53,udp,dns,64,111,1,83,1,194,2,normal,-
6697072437334712778,10.0.2.15,8.8.8.8,53,udp,dns,67,147,1,91,1,238,2,normal,-
5845678754505372310,10.0.2.15,34.117.237.239,443,tcp,-,78698,546,8,573,8,1119,16,normal,-
2308860423956264662,10.0.2.15,8.8.8.8,53,udp,dns,40,146,1,81,1,227,2,normal,-
6675209470296203134,10.0.2.15,142.251.36.142,443,udp,-,2136,52147,40,7042,22,59189,62,normal,-
-4283970306643718448,10.0.2.15,8.8.8.8,53,udp,dns,49,459,1,85,1,544,2,normal,-
-290682973927417557,10.0.2.15,8.8.8.8,53,udp,dns,40,207,1,114,1,321,2,normal,-
1095910400128251287,10.0.2.15,8.8.8.8,53,udp,dns,39,187,1,116,1,303,2,normal,-
4397031820495027893,10.0.2.15,192.229.221.95,80,tcp,-,84814,660,11,594,11,1254,22,normal,-
-3162503648568457283,10.0.2.15,142.251.36.132,443,tcp,-,77337,486,7,519,7,1005,14,normal,-
-5766530370724998701,10.0.2.15,142.251.36.131,80,tcp,-,74453,600,10,540,10,1140,20,normal,-
8117928466572403272,10.0.2.15,151.101.194.110,443,tcp,-,60767,705,10,655,9,1360,19,normal,-
4102996935442087492,10.0.2.15,8.8.8.8,53,udp,dns,36,135,1,84,1,219,2,normal,-
-5601181542812256484,10.0.2.15,142.251.37.99,443,tcp,-,48,60,1,128,2,188,3,normal,-
-7328621371905594686,10.0.2.15,8.8.8.8,53,udp,dns,108,145,1,89,1,234,2,normal,-
1492239615838909269,10.0.2.15,65.9.9.138,80,tcp,http,46845,4667,15,2616,16,7283,31,normal,-
-3913325809880058018,10.0.2.15,8.8.8.8,53,udp,dns,42,183,1,83,1,266,2,normal,-
4994486539406140343,10.0.2.15,8.8.8.8,53,udp,dns,53,229,1,90,1,319,2,normal,-
4931371435226410858,10.0.2.15,8.8.8.8,53,udp,dns,66,158,1,90,1,248,2,normal,-
7363085025662336932,10.0.2.15,95.100.146.41,80,tcp,-,74720,600,10,540,10,1140,20,normal,-
905725642327190239,10.0.2.15,8.8.8.8,53,udp,dns,69,226,1,90,1,316,2,normal,-
7768746703732253864,10.0.2.15,142.251.36.142,443,tcp,-,27724,12157,21,1428,20,13585,41,normal,-
-4313313796564247800,10.0.2.15,104.17.130.110,443,tcp,-,94795,775,9,793,9,1568,18,normal,-
7081029068504037375,10.0.2.15,104.244.42.67,443,tcp,-,95248,1272,12,1369,11,2641,23,normal,-
2090813383395149465,10.0.2.15,8.8.8.8,53,udp,dns,69,238,1,95,1,333,2,normal,-
-2824035928768460979,10.0.2.15,8.8.8.8,53,udp,dns,68,177,1,84,1,261,2,normal,-
-9040188829209646969,10.0.2.15,216.239.36.178,443,udp,-,12248,2483,31,7470,21,9953,52,normal,-
-8476837547367518534,10.0.2.15,104.18.20.226,80,tcp,http,17701,2316,7,890,8,3206,15,normal,-
8028348690962080345,10.0.2.15,8.8.8.8,53,udp,dns,39,116,1,88,1,204,2,normal,-
3937373822285465532,10.0.2.15,8.8.8.8,53,udp,dns,57,160,1,83,1,243,2,normal,-
8446121270803458903,10.0.2.15,8.8.8.8,53,udp,dns,50,307,1,101,1,408,2,normal,-
-4605732250450916164,10.0.2.15,8.8.8.8,53,udp,dns,60,153,1,96,1,249,2,normal,-
-4704331822509487602,10.0.2.15,192.229.221.95,80,tcp,-,97348,2555,15,1658,15,4213,30,normal,-
-6679770160078602990,10.0.2.15,8.8.8.8,53,udp,dns,58,156,1,95,1,251,2,normal,-
1042993993939569756,10.0.2.15,34.120.208.123,443,tcp,-,79101,21510,165,112742,148,134252,313,normal,-
696805363348059533,10.0.2.15,95.100.146.34,443,tcp,-,96986,1091,12,848,11,1939,23,normal,-
3153718292100594183,10.0.2.15,8.8.8.8,53,udp,dns,54,157,1,103,1,260,2,normal,-
1172291384050465913,10.0.2.15,8.8.8.8,53,udp,dns,61,137,1,82,1,219,2,normal,-
-6408612185758716365,10.0.2.15,8.8.8.8,53,udp,dns,55,143,1,86,1,229,2,normal,-
7382312159985008901,10.0.2.15,8.8.8.8,53,udp,dns,21267,317,2,176,2,493,4,normal,-
6929930302823971231,10.0.2.15,8.8.8.8,53,udp,dns,65,203,1,114,1,317,2,normal,-
6576399671864171703,10.0.2.15,142.251.36.131,443,udp,-,12933,1191,13,3595,12,4786,25,normal,-
-4274409034286457950,10.0.2.15,192.0.77.48,443,tcp,-,94,60,1,128,2,188,3,normal,-
-7493059990416206637,10.0.2.15,8.8.8.8,53,udp,dns,137,294,2,181,2,475,4,normal,-
3328230842751055900,10.0.2.15,142.251.36.130,443,udp,-,189,6976,8,1983,7,8959,15,normal,-
-6747053717653620401,10.0.2.15,8.8.8.8,53,udp,dns,46,119,1,91,1,210,2,normal,-
-8040510245876875717,10.0.2.15,142.251.36.65,443,udp,-,3955,13061,17,3009,14,16070,31,normal,-
6718973728230447380,10.0.2.15,8.8.8.8,53,udp,dns,59,191,1,85,1,276,2,normal,-
1822681093048687462,10.0.2.15,8.8.8.8,53,udp,dns,63,286,1,88,1,374,2,normal,-
-6872670602388577065,10.0.2.15,8.8.8.8,53,udp,dns,52,149,1,92,1,241,2,normal,-
945516594532487466,10.0.2.15,104.18.136.59,443,tcp,-,95564,1273,9,629,8,1902,17,normal,-
-5330529799303462761,10.0.2.15,8.8.8.8,53,udp,dns,81,135,1,84,1,219,2,normal,-
-2843085455031264464,10.0.2.15,216.239.34.36,443,udp,-,971,4923,5,2676,4,7599,9,normal,-
-566208422397655666,10.0.2.15,8.8.8.8,53,udp,dns,101,146,1,81,1,227,2,normal,-
799077231406966314,10.0.2.15,8.8.8.8,53,udp,dns,43,149,1,92,1,241,2,normal,-
-2328090630214546394,10.0.2.15,35.186.249.72,443,udp,-,161,8418,8,1905,6,10323,14,normal,-
2147895915924497333,10.0.2.15,104.19.187.97,443,tcp,-,96269,3036,12,1072,12,4108,24,normal,-
1407597919218579740,10.0.2.15,8.8.8.8,53,udp,dns,102,170,1,88,1,258,2,normal,-
-6750556029512601632,10.0.2.15,198.143.164.252,80,tcp,http,9537,646,5,729,6,1375,11,normal,-
-1726415270314872554,10.0.2.15,8.8.8.8,53,udp,dns,68,149,1,84,1,233,2,normal,-
-8888960138463026672,10.0.2.15,8.8.8.8,53,udp,dns,51,166,1,105,1,271,2,normal,-
1457151144419804641,10.0.2.15,8.8.8.8,53,udp,dns,53,220,1,91,1,311,2,normal,-
-3526019677791752317,10.0.2.15,8.8.8.8,53,udp,dns,65,135,1,84,1,219,2,normal,-
4173795075423486187,10.0.2.15,8.8.8.8,53,udp,dns,58,207,1,114,1,321,2,normal,-
-7376759410725249678,10.0.2.15,157.240.30.35,443,udp,-,7620,2935,12,2903,8,5838,20,normal,-
-6786238457976988455,10.0.2.15,142.251.36.130,443,udp,-,12161,2910,18,4772,16,7682,34,normal,-
-604000679221656253,10.0.2.15,8.8.8.8,53,udp,dns,49,166,1,105,1,271,2,normal,-
-6264120226526675144,10.0.2.15,142.251.36.78,443,udp,-,25269,953114,776,66283,243,1019397,1019,normal,-
-1837609832113290544,10.0.2.15,8.8.8.8,53,udp,dns,51,154,1,93,1,247,2,normal,-
3275758125061393217,10.0.2.15,8.8.8.8,53,udp,dns,83,178,1,97,1,275,2,normal,-
-2555398046636288502,10.0.2.15,8.8.8.8,53,udp,dns,115,174,1,93,1,267,2,normal,-
-7108293293732226187,10.0.2.15,8.8.8.8,53,udp,dns,41,116,1,84,1,200,2,normal,-
9161256270185320180,10.0.2.15,8.8.8.8,53,udp,dns,52,189,1,118,1,307,2,normal,-
-6932832108537432554,10.0.2.15,142.251.37.110,443,udp,-,258,9725,11,2366,10,12091,21,normal,-
6306429989804664909,10.0.2.15,8.8.8.8,53,udp,dns,67,107,1,79,1,186,2,normal,-
-6023900284541924455,10.0.2.15,198.143.164.252,80,tcp,-,5964,180,3,236,4,416,7,normal,-
1672658749576594587,10.0.2.15,8.8.8.8,53,udp,dns,71,170,1,83,1,253,2,normal,-
-2326075050413999027,10.0.2.15,13.107.21.200,443,tcp,-,95032,1841,18,2543,18,4384,36,normal,-
-8945132655761952315,10.0.2.15,8.8.8.8,53,udp,dns,267,329,2,170,2,499,4,normal,-
-8772763807456032629,10.0.2.15,8.8.8.8,53,udp,dns,53,155,1,99,1,254,2,normal,-
3517563201385166245,10.0.2.15,8.8.8.8,53,udp,dns,69,180,1,95,1,275,2,normal,-
-5632377351605570550,10.0.2.15,8.8.8.8,53,udp,dns,53,163,1,102,1,265,2,normal,-
9142376465822704248,10.0.2.15,8.8.8.8,53,udp,dns,86,137,1,82,1,219,2,normal,-
-7998570956339679270,10.0.2.15,8.8.8.8,53,udp,dns,59,123,1,86,1,209,2,normal,-
-8820052842698527280,10.0.2.15,8.8.8.8,53,udp,dns,99,363,1,91,1,454,2,normal,-
522725683234407244,10.0.2.15,8.8.8.8,53,udp,dns,67,149,1,92,1,241,2,normal,-
-4847938318322202731,10.0.2.15,216.239.34.36,443,udp,-,16799,3095,37,6918,29,10013,66,normal,-
8368343016157415613,10.0.2.15,8.8.8.8,53,udp,dns,62,210,1,118,1,328,2,normal,-
4786069400216941743,10.0.2.15,8.8.8.8,53,udp,dns,86,208,1,92,1,300,2,normal,-
879013374176786674,10.0.2.15,199.59.243.223,80,tcp,http,24069,54934,54,11687,39,66621,93,normal,-
3221653869296902221,10.0.2.15,8.8.8.8,53,udp,dns,60,206,1,95,1,301,2,normal,-
-3308120347616665594,10.0.2.15,8.8.8.8,53,udp,dns,55,324,1,100,1,424,2,normal,-
5948944050707901253,10.0.2.15,8.8.8.8,53,udp,dns,67,294,1,85,1,379,2,normal,-
4081574267241281630,10.0.2.15,8.8.8.8,53,udp,dns,50,213,1,87,1,300,2,normal,-
2571351479245817573,10.0.2.15,65.9.9.138,80,tcp,http,13684,1302,6,831,7,2133,13,normal,-
-4928808560389585552,10.0.2.15,8.8.8.8,53,udp,dns,69,138,1,93,1,231,2,normal,-
3680012424910695575,10.0.2.15,192.229.221.95,80,tcp,-,100593,2430,15,1658,15,4088,30,normal,-
-7882651038991227796,10.0.2.15,8.8.8.8,53,udp,dns,51,323,1,85,1,408,2,normal,-
-1622833139695180858,10.0.2.15,157.240.253.60,443,udp,-,128,5296,8,1825,5,7121,13,normal,-
-2008550741389759205,10.0.2.15,142.251.36.131,80,tcp,-,96294,4739,21,3268,21,8007,42,normal,-
-4040896008199690331,10.0.2.15,8.8.8.8,53,udp,dns,74,187,1,116,1,303,2,normal,-
-3305842738438276971,10.0.2.15,8.8.8.8,53,udp,dns,68,143,1,86,1,229,2,normal,-
6502886139512174099,10.0.2.15,142.251.37.100,443,udp,-,8542,24002,62,15591,46,39593,108,normal,-
8181948086208330850,10.0.2.15,8.8.8.8,53,udp,dns,60,126,1,98,1,224,2,normal,-
7220758426840476617,10.0.2.15,142.251.37.100,443,udp,-,13319,3898,20,5080,17,8978,37,normal,-
-3318203247854809260,10.0.2.15,8.8.8.8,53,udp,dns,42,146,1,81,1,227,2,normal,-
4221557453559428884,10.0.2.15,8.8.8.8,53,udp,dns,59,122,1,90,1,212,2,normal,-
6882269090052593201,10.0.2.15,8.8.8.8,53,udp,dns,61,187,1,116,1,303,2,normal,-
-634815062129279491,10.0.2.15,142.251.36.66,443,udp,-,11679,4048,13,2170,10,6218,23,normal,-
469919701852737687,10.0.2.15,8.8.8.8,53,udp,dns,48,204,1,92,1,296,2,normal,-
1257571284313259053,10.0.2.15,23.195.249.173,443,tcp,tls,49357,1100341,888,108708,529,1209049,1417,normal,-
6172619106407694745,10.0.2.15,23.195.248.219,443,tcp,-,62136,684,10,627,9,1311,19,normal,-
7075107062994790930,10.0.2.15,8.8.8.8,53,udp,dns,470,97,1,81,1,178,2,normal,-
7021683816010747340,10.0.2.15,8.8.8.8,53,udp,dns,78,94,1,78,1,172,2,normal,-
-1793119721798541109,10.0.2.15,204.79.197.203,80,tcp,http,43986,2913,11,1103,12,4016,23,normal,-
-945441325288938158,10.0.2.15,8.8.8.8,53,udp,dns,53,312,1,81,1,393,2,normal,-
8252635874886782794,10.0.2.15,8.8.8.8,53,udp,dns,66,140,1,80,1,220,2,normal,-
7684583500292686769,10.0.2.15,142.251.36.72,443,udp,-,668,87959,67,3197,21,91156,88,normal,-
2994378953561533982,10.0.2.15,142.251.36.142,443,tcp,-,39,60,1,128,2,188,3,normal,-
173159412462618513,10.0.2.15,104.16.57.101,443,tcp,-,63122,546,8,573,8,1119,16,normal,-
-4107965828322773596,10.0.2.15,142.251.36.131,80,tcp,-,74453,600,10,540,10,1140,20,normal,-
8938202127678009093,10.0.2.15,151.101.193.140,443,tcp,-,94668,797,9,1164,9,1961,18,normal,-
-2650582582968148383,10.0.2.15,8.8.8.8,53,udp,dns,61,146,1,90,1,236,2,normal,-
-4129602233975513604,10.0.2.15,8.8.8.8,53,udp,dns,70,152,1,88,1,240,2,normal,-
-3786855697298034430,10.0.2.15,8.8.8.8,53,udp,dns,50,161,1,105,1,266,2,normal,-
5249874537591544740,10.0.2.15,34.107.221.82,80,tcp,-,97319,990,13,1005,13,1995,26,normal,-
-5426889841216051200,10.0.2.15,8.8.8.8,53,udp,dns,68,112,1,80,1,192,2,normal,-
2885261706160419206,10.0.2.15,8.8.8.8,53,udp,dns,63,109,1,93,1,202,2,normal,-
-8098652217641088381,10.0.2.15,8.8.8.8,53,udp,dns,38,268,1,100,1,368,2,normal,-
-1919697766602022949,10.0.2.15,8.8.8.8,53,udp,dns,59,176,1,95,1,271,2,normal,-
5875590550975864768,10.0.2.15,8.8.8.8,53,udp,dns,207,96,1,80,1,176,2,normal,-
-6264535847428602115,10.0.2.15,8.8.8.8,53,udp,dns,52,207,1,114,1,321,2,normal,-
7427364160675958499,10.0.2.15,8.8.8.8,53,udp,dns,47,207,1,114,1,321,2,normal,-
6734552894477448251,10.0.2.15,8.8.8.8,53,udp,dns,52,167,1,83,1,250,2,normal,-
253120793518356413,10.0.2.15,8.8.8.8,53,udp,dns,48,363,1,85,1,448,2,normal,-
2203076887148451749,10.0.2.15,8.8.8.8,53,udp,dns,83,164,1,100,1,264,2,normal,-
-6374163860603833776,10.0.2.15,8.8.8.8,53,udp,dns,64,251,1,102,1,353,2,normal,-
4455370590915161725,10.0.2.15,142.251.36.72,443,udp,-,479,3690,5,4587,6,8277,11,normal,-
949975737149671250,10.0.2.15,35.241.9.150,443,tcp,-,72547,486,7,519,7,1005,14,normal,-
-2924005670553975771,10.0.2.15,8.8.8.8,53,udp,dns,90,207,1,114,1,321,2,normal,-
8757396993060905143,10.0.2.15,8.8.8.8,53,udp,dns,55,149,1,92,1,241,2,normal,-
-8604806727664577238,10.0.2.15,8.8.8.8,53,udp,dns,118,349,2,171,2,520,4,normal,-
7620849556592634608,10.0.2.15,8.8.8.8,53,udp,dns,38,187,1,116,1,303,2,normal,-
-7955517440507061138,10.0.2.15,8.8.8.8,53,udp,dns,50,295,1,94,1,389,2,normal,-
5031143629902735107,10.0.2.15,192.229.221.95,80,tcp,-,95204,1455,12,1072,12,2527,24,normal,-
6383649569341648356,10.0.2.15,8.8.8.8,53,udp,dns,71,143,1,86,1,229,2,normal,-
-4591529919703163311,10.0.2.15,8.8.8.8,53,udp,dns,66,163,1,107,1,270,2,normal,-
-2623894272105007104,10.0.2.15,142.251.37.110,443,udp,-,770,3942,8,5031,10,8973,18,normal,-
-2687487194029262176,10.0.2.15,8.8.8.8,53,udp,dns,131,103,1,87,1,190,2,normal,-
592361223310728706,10.0.2.15,8.8.8.8,53,udp,dns,60,181,1,97,1,278,2,normal,-
-1859419265275585726,10.0.2.15,8.8.8.8,53,udp,dns,66,184,1,114,1,298,2,normal,-
3231811853275068996,10.0.2.15,8.8.8.8,53,udp,dns,46,146,1,81,1,227,2,normal,-
3677461639412204368,10.0.2.15,8.8.8.8,53,udp,dns,104,363,1,91,1,454,2,normal,-
-5630629506790386721,10.0.2.15,8.8.8.8,53,udp,dns,103,111,1,95,1,206,2,normal,-
-7466169426224343842,10.0.2.15,8.8.8.8,53,udp,dns,46,189,1,118,1,307,2,normal,-
-5360136048004238583,10.0.2.15,8.8.8.8,53,udp,dns,70,189,1,118,1,307,2,normal,-
-3467491227667655945,10.0.2.15,34.107.221.82,80,tcp,-,96996,1012,12,949,12,1961,24,normal,-
3521140253159323875,10.0.2.15,8.8.8.8,53,udp,dns,35,153,1,92,1,245,2,normal,-
2810971755423115009,10.0.2.15,8.8.8.8,53,udp,dns,100,350,1,83,1,433,2,normal,-
-6062625388813240395,10.0.2.15,8.8.8.8,53,udp,dns,71,112,1,84,1,196,2,normal,-
-4250461451164764785,10.0.2.15,8.8.8.8,53,udp,dns,100,190,1,84,1,274,2,normal,-
-4813414583354151840,10.0.2.15,65.9.94.185,443,tcp,-,86,60,1,128,2,188,3,normal,-
-6023823885637207701,10.0.2.15,8.8.8.8,53,udp,dns,70,114,1,86,1,200,2,normal,-
2180380976436217341,10.0.2.15,8.8.8.8,53,udp,dns,68,102,1,86,1,188,2,normal,-
6253987232972348030,10.0.2.15,104.17.50.95,443,tcp,-,62957,546,8,573,8,1119,16,normal,-
2673006857184073916,10.0.2.15,8.8.8.8,53,udp,dns,100,363,1,91,1,454,2,normal,-
-7115384927912765101,10.0.2.15,8.8.8.8,53,udp,dns,34,107,1,91,1,198,2,normal,-
355162675712768008,10.0.2.15,8.8.8.8,53,udp,dns,100,190,1,83,1,273,2,normal,-
8137602435088270546,10.0.2.15,8.8.8.8,53,udp,dns,39,170,1,88,1,258,2,normal,-
4695089987297831376,10.0.2.15,13.107.42.14,443,tcp,-,95426,7485,21,2355,21,9840,42,normal,-
-1615927981394554371,10.0.2.15,8.8.8.8,53,udp,dns,74,186,1,94,1,280,2,normal,-
4488860625532908712,10.0.2.15,8.8.8.8,53,udp,dns,62,99,1,83,1,182,2,normal,-
-3009782267530119794,10.0.2.15,8.8.8.8,53,udp,dns,88,148,1,84,1,232,2,normal,-
-246124546729538598,10.0.2.15,8.8.8.8,53,udp,dns,86,112,1,80,1,192,2,normal,-
4834591980253564376,10.0.2.15,8.8.8.8,53,udp,dns,49,149,1,92,1,241,2,normal,-
-5269529264226365077,10.0.2.15,142.251.36.97,443,udp,-,188,11903,10,2065,8,13968,18,normal,-
8782933784707400264,10.0.2.15,8.8.8.8,53,udp,dns,56,114,1,98,1,212,2,normal,-
1699620228655711820,10.0.2.15,95.100.146.41,80,tcp,-,74972,600,10,540,10,1140,20,normal,-
-1192011376466743504,10.0.2.15,8.8.8.8,53,udp,dns,54,152,1,96,1,248,2,normal,-
5601172674130905013,10.0.2.15,104.244.42.133,443,tcp,-,94608,835,9,1263,9,2098,18,normal,-
5962255300801489082,10.0.2.15,104.16.138.206,443,tcp,-,83213,22274,21,784,11,23058,32,normal,-
4820058046603771714,10.0.2.15,8.8.8.8,53,udp,dns,58,149,1,93,1,242,2,normal,-
-3478682760614087261,10.0.2.15,8.8.8.8,53,udp,dns,97,298,2,206,2,504,4,normal,-
1270756214470719878,10.0.2.15,8.8.8.8,53,udp,dns,72,137,1,82,1,219,2,normal,-
-2435519023536503078,10.0.2.15,8.8.8.8,53,udp,dns,43,207,1,114,1,321,2,normal,-
-4034247496437085545,10.0.2.15,8.8.8.8,53,udp,dns,79,121,1,93,1,214,2,normal,-
-5985850332621209614,10.0.2.15,8.8.8.8,53,udp,dns,55,190,1,90,1,280,2,normal,-
9044298736467036327,10.0.2.15,8.8.8.8,53,udp,dns,88,290,2,162,2,452,4,normal,-
-3656807685847022394,10.0.2.15,104.19.154.83,443,udp,-,12990,6279,12,2582,12,8861,24,normal,-
2905145877189995215,10.0.2.15,8.8.8.8,53,udp,dns,52,136,1,86,1,222,2,normal,-
1617664744258727943,10.0.2.15,142.251.36.77,443,udp,-,193,9635,10,2153,9,11788,19,normal,-
1483727758357886735,10.0.2.15,142.251.36.72,443,udp,-,180,2290,4,1628,3,3918,7,normal,-
-7699296089144769034,10.0.2.15,8.8.8.8,53,udp,dns,47,178,1,97,1,275,2,normal,-
5595076997422446034,10.0.2.15,8.8.8.8,53,udp,dns,70,218,1,88,1,306,2,normal,-
8284039941858070931,10.0.2.15,8.8.8.8,53,udp,dns,70,141,1,82,1,223,2,normal,-
-620779973157575110,10.0.2.15,8.8.8.8,53,udp,dns,54,143,1,86,1,229,2,normal,-
4875826734969485211,10.0.2.15,95.100.146.41,80,tcp,-,74971,600,10,540,10,1140,20,normal,-
-1642881014954193512,10.0.2.15,8.8.8.8,53,udp,dns,83,288,1,92,1,380,2,normal,-
-2484360852079428961,10.0.2.15,8.8.8.8,53,udp,dns,38,194,1,82,1,276,2,normal,-
596782682877286349,10.0.2.15,2.16.2.192,443,tcp,-,60113,486,7,519,7,1005,14,normal,-
2477976516081739692,10.0.2.15,8.8.8.8,53,udp,dns,47,233,1,101,1,334,2,normal,-
8132458834690926587,10.0.2.15,8.8.8.8,53,udp,dns,46,336,1,81,1,417,2,normal,-
-4558310092254998980,10.0.2.15,8.8.8.8,53,udp,dns,58,98,1,82,1,180,2,normal,-
-8622395564952698566,10.0.2.15,8.8.8.8,53,udp,dns,51,174,1,91,1,265,2,normal,-
-1271217421063907943,10.0.2.15,151.101.193.140,443,tcp,-,60849,684,10,627,9,1311,19,normal,-
-4153240041986931743,10.0.2.15,8.8.8.8,53,udp,dns,165,148,1,94,1,242,2,normal,-
4405583682825853086,10.0.2.15,104.16.57.101,443,tcp,-,97758,885,11,1536,11,2421,22,normal,-
6827096830040418214,10.0.2.15,8.8.8.8,53,udp,dns,39,204,1,122,1,326,2,normal,-
5033696356175773173,10.0.2.15,142.251.36.78,443,udp,-,257,7346,8,2153,9,9499,17,normal,-
5775713835136736964,10.0.2.15,8.8.8.8,53,udp,dns,48,156,1,92,1,248,2,normal,-
8820724873318453283,10.0.2.15,8.8.8.8,53,udp,dns,64,195,1,91,1,286,2,normal,-
-3524128833574853014,10.0.2.15,8.8.8.8,53,udp,dns,62,145,1,83,1,228,2,normal,-
1981861163212196456,10.0.2.15,8.8.8.8,53,udp,dns,55,189,1,118,1,307,2,normal,-
-3774916388296064259,10.0.2.15,8.8.8.8,53,udp,dns,96,411,2,236,2,647,4,normal,-
5298352247989573266,10.0.2.15,142.251.36.98,443,udp,-,7376,3189,8,2230,6,5419,14,normal,-
7933375671297731882,10.0.2.15,8.8.8.8,53,udp,dns,49,146,1,81,1,227,2,normal,-
-7053780724374135055,10.0.2.15,142.251.36.78,443,udp,-,19971,12859,20,3166,14,16025,34,normal,-
9114948829959309824,10.0.2.15,8.8.8.8,53,udp,dns,68,270,1,85,1,355,2,normal,-
4396901643576640783,10.0.2.15,8.8.8.8,53,udp,dns,75,351,1,85,1,436,2,normal,-
1453368287773058467,10.0.2.15,8.8.8.8,53,udp,dns,126,266,2,173,2,439,4,normal,-
-1359636853356159086,10.0.2.15,8.8.8.8,53,udp,dns,62,198,1,120,1,318,2,normal,-
228239900367614075,10.0.2.15,8.8.8.8,53,udp,dns,47,102,1,86,1,188,2,normal,-
-3230900768079682147,10.0.2.15,8.8.8.8,53,udp,dns,54,184,1,85,1,269,2,normal,-
-204906376951273534,10.0.2.15,8.8.8.8,53,udp,dns,86,148,1,92,1,240,2,normal,-
6255191725259129249,10.0.2.15,8.8.8.8,53,udp,dns,87,142,1,80,1,222,2,normal,-
-4551879989444855865,10.0.2.15,142.251.36.99,443,tcp,-,68,60,1,128,2,188,3,normal,-
-1613175769912410465,10.0.2.15,8.8.8.8,53,udp,dns,106,155,1,94,1,249,2,normal,-
-3304077169060027084,10.0.2.15,8.8.8.8,53,udp,dns,45,148,1,92,1,240,2,normal,-
2164397784548350549,10.0.2.15,104.19.155.83,443,tcp,-,882,1040,5,629,5,1669,10,normal,-
3131731760186607453,10.0.2.15,8.8.8.8,53,udp,dns,64,209,1,102,1,311,2,normal,-
-5311831291132844329,10.0.2.15,8.8.8.8,53,udp,dns,46,161,1,103,1,264,2,normal,-
-1036965660348546362,10.0.2.15,8.8.8.8,53,udp,dns,37,187,1,116,1,303,2,normal,-
-9205791257950699084,10.0.2.15,8.8.8.8,53,udp,dns,55,179,1,81,1,260,2,normal,-
8303874139432318454,10.0.2.15,8.8.8.8,53,udp,dns,67,114,1,86,1,200,2,normal,-
-3599098855385404314,10.0.2.15,8.8.8.8,53,udp,dns,94,239,1,91,1,330,2,normal,-
-7277476917645679263,10.0.2.15,142.251.36.132,443,udp,-,56090,21659,115,11079,90,32738,205,normal,-
-4033147074596380096,10.0.2.15,8.8.8.8,53,udp,dns,68,149,1,92,1,241,2,normal,-
116279088770496551,10.0.2.15,8.8.8.8,53,udp,dns,57,119,1,91,1,210,2,normal,-
-1037013542283716767,10.0.2.15,8.8.8.8,53,udp,dns,61,113,1,97,1,210,2,normal,-
6154452742647527589,10.0.2.15,146.75.116.157,443,tcp,-,95192,931,12,873,11,1804,23,normal,-
3718077717177834257,10.0.2.15,65.9.95.108,443,tcp,-,59712,546,8,573,8,1119,16,normal,-
7126021031946613616,10.0.2.15,8.8.8.8,53,udp,dns,57,217,1,90,1,307,2,normal,-
-5736882847566040670,10.0.2.15,192.0.77.48,443,tcp,-,93,60,1,128,2,188,3,normal,-
384650976313246562,10.0.2.15,199.59.243.223,80,tcp,http,29341,39400,47,10229,45,49629,92,normal,-
3252472329890990740,8.8.8.8,10.0.2.15,57212,udp,-,0,0,0,268,1,268,1,normal,-
3934444193485786282,10.0.2.15,8.8.8.8,53,udp,dns,52,171,1,90,1,261,2,normal,-
-2728359519581703450,10.0.2.15,142.251.36.78,443,udp,-,249,9737,11,2359,10,12096,21,normal,-
-9123943546250375093,10.0.2.15,8.8.8.8,53,udp,dns,48,114,1,98,1,212,2,normal,-
3613684188722293838,10.0.2.15,8.8.8.8,53,udp,dns,74,180,1,84,1,264,2,normal,-
1192737737036268174,10.0.2.15,8.8.8.8,53,udp,dns,55,312,1,91,1,403,2,normal,-
-5106418864483348088,10.0.2.15,8.8.8.8,53,udp,dns,95,158,1,98,1,256,2,normal,-
-366301586925394805,10.0.2.15,8.8.8.8,53,udp,dns,55,152,1,96,1,248,2,normal,-
-8415483337128760793,10.0.2.15,8.8.8.8,53,udp,dns,50,319,1,94,1,413,2,normal,-
3255512130654263481,10.0.2.15,8.8.8.8,53,udp,dns,61,113,1,97,1,210,2,normal,-
2070690157790112610,10.0.2.15,8.8.8.8,53,udp,dns,89,363,1,91,1,454,2,normal,-
7597037886117606660,10.0.2.15,142.251.36.134,443,udp,-,235,7217,8,2064,8,9281,16,normal,-
8465983838395506698,10.0.2.15,8.8.8.8,53,udp,dns,51,166,1,102,1,268,2,normal,-
8333268871465582858,10.0.2.15,8.8.8.8,53,udp,dns,94,239,1,91,1,330,2,normal,-
6654581103458320898,10.0.2.15,8.8.8.8,53,udp,dns,67,95,1,79,1,174,2,normal,-
3480921339857199593,10.0.2.15,8.8.8.8,53,udp,dns,36,145,1,84,1,229,2,normal,-
-7363585165294480690,10.0.2.15,8.8.8.8,53,udp,dns,47,135,1,84,1,219,2,normal,-
-605766248599906140,10.0.2.15,8.8.8.8,53,udp,dns,64,273,1,104,1,377,2,normal,-
-2783733456205039185,10.0.2.15,8.8.8.8,53,udp,dns,78,182,1,90,1,272,2,normal,-
7473053209663333619,10.0.2.15,65.9.95.94,443,tcp,-,95919,829,8,693,8,1522,16,normal,-
7598526114712688141,10.0.2.15,8.8.8.8,53,udp,dns,77,235,1,95,1,330,2,normal,-
6641493490680474873,10.0.2.15,8.8.8.8,53,udp,dns,66,166,1,100,1,266,2,normal,-
2253902108234855898,10.0.2.15,8.8.8.8,53,udp,dns,57,205,1,91,1,296,2,normal,-
-2379940076882265173,10.0.2.15,8.8.8.8,53,udp,dns,87,232,1,90,1,322,2,normal,-
-515760580228313860,10.0.2.15,8.8.8.8,53,udp,dns,64,218,1,95,1,313,2,normal,-
-6086332486346426505,10.0.2.15,142.251.36.142,443,udp,-,625,3942,8,5144,11,9086,19,normal,-
-4478312099780420461,10.0.2.15,142.251.37.100,443,udp,-,7019,3099,8,2153,5,5252,13,normal,-
-7587305057072137592,10.0.2.15,8.8.8.8,53,udp,dns,55,143,1,86,1,229,2,normal,-
-1837484634316832153,10.0.2.15,142.251.37.100,443,udp,-,133,2290,4,1629,3,3919,7,normal,-
-1574298014783407094,10.0.2.15,8.8.8.8,53,udp,dns,50,178,1,97,1,275,2,normal,-
-3022017502108002667,10.0.2.15,8.8.8.8,53,udp,dns,101,428,2,178,2,606,4,normal,-
4187694082011248329,10.0.2.15,8.8.8.8,53,udp,dns,51,277,1,85,1,362,2,normal,-
-2579837489407121054,10.0.2.15,142.251.36.98,443,udp,-,161,10305,9,2151,9,12456,18,normal,-
-2305973253525726382,10.0.2.15,8.8.8.8,53,udp,dns,75,207,1,114,1,321,2,normal,-
-4050167514627917880,10.0.2.15,8.8.8.8,53,udp,dns,74,139,1,78,1,217,2,normal,-
-2437197091675583726,10.0.2.15,8.8.8.8,53,udp,dns,78,118,1,90,1,208,2,normal,-
-9126457771916433999,10.0.2.15,17.8.136.126,443,tcp,tls,31539,6316,18,3272,18,9588,36,normal,-
3492034549156848803,10.0.2.15,8.8.8.8,53,udp,dns,103,167,1,83,1,250,2,normal,-
-7374299675913207156,10.0.2.15,104.17.49.95,443,udp,-,15047,299731,404,168250,226,467981,630,normal,-
-233798136662982383,10.0.2.15,8.8.8.8,53,udp,dns,54,208,1,85,1,293,2,normal,-
-4179706809844655185,10.0.2.15,142.251.36.150,443,udp,-,1961,834914,610,15341,134,850255,744,normal,-
-7015834202725415576,10.0.2.15,157.240.30.27,443,udp,-,494,4118,12,4599,6,8717,18,normal,-
8775827324590165869,104.19.155.83,10.0.2.15,46357,udp,-,14368,1332,4,1220,4,2552,8,normal,-
3628614763781868761,10.0.2.15,8.8.8.8,53,udp,dns,46,141,1,82,1,223,2,normal,-
3470549411588266595,10.0.2.15,8.8.8.8,53,udp,dns,44,178,1,97,1,275,2,normal,-
8635360588533970788,10.0.2.15,8.8.8.8,53,udp,dns,57,107,1,91,1,198,2,normal,-
-8087750525008950589,10.0.2.15,8.8.8.8,53,udp,dns,63,171,1,87,1,258,2,normal,-
3936222894564206174,10.0.2.15,142.251.36.78,443,udp,-,245,9726,11,2446,11,12172,22,normal,-
-2872553461717673888,10.0.2.15,8.8.8.8,53,udp,dns,53,207,1,88,1,295,2,normal,-
3388163460003463407,10.0.2.15,8.8.8.8,53,udp,dns,50,143,1,86,1,229,2,normal,-
6613812504112418224,10.0.2.15,8.8.8.8,53,udp,dns,83775,297,2,184,2,481,4,normal,-
5580040719231676674,10.0.2.15,34.107.204.85,443,udp,-,17353,7770,23,6662,25,14432,48,normal,-
-5361560765438657006,10.0.2.15,8.8.8.8,53,udp,dns,67,113,1,97,1,210,2,normal,-
1226071344221243935,10.0.2.15,8.8.8.8,53,udp,dns,44,183,1,81,1,264,2,normal,-
6489819357566943541,10.0.2.15,8.8.8.8,53,udp,dns,55,174,1,93,1,267,2,normal,-
-6486932187136405261,10.0.2.15,8.8.8.8,53,udp,dns,64,149,1,92,1,241,2,normal,-
161486107155801458,10.0.2.15,8.8.8.8,53,udp,dns,43,143,1,86,1,229,2,normal,-
3402913048584127782,10.0.2.15,142.251.37.100,443,tcp,-,60,60,1,128,2,188,3,normal,-
5516858401228197938,10.0.2.15,142.251.37.99,443,tcp,-,38,60,1,128,2,188,3,normal,-
7888796342074967362,10.0.2.15,151.101.192.176,443,tcp,-,95533,1189,11,966,11,2155,22,normal,-
-3351623603526139345,10.0.2.15,104.19.188.97,443,tcp,-,67,60,1,128,2,188,3,normal,-
3160541363091556736,10.0.2.15,13.107.42.14,443,tcp,tls,217,5728,13,1568,12,7296,25,normal,-
5387295003094617293,10.0.2.15,34.120.208.123,443,tcp,tls,861,4770,11,1460,12,6230,23,normal,-
3422905685555781048,10.0.2.15,13.107.21.200,443,tcp,tls,776,8223,13,1622,13,9845,26,normal,-
-6315600828307988504,10.0.2.15,142.251.36.130,443,tcp,tls,329,8067,23,2760,21,10827,44,normal,-
-3467504079019527773,10.0.2.15,142.251.36.74,443,tcp,tls,401,6777,15,2204,16,8981,31,normal,-
866018783903234789,10.0.2.15,31.30.189.145,443,tcp,tls,194,4063,12,1406,11,5469,23,normal,-
1869330383786983621,10.0.2.15,104.19.188.97,443,tcp,-,68,60,1,128,2,188,3,normal,-
6844333169190326384,10.0.2.15,142.251.36.110,443,tcp,tls,27568,9203,20,2308,18,11511,38,normal,-
-2915785680577156300,10.0.2.15,157.240.30.35,443,tcp,-,71,60,1,128,2,188,3,normal,-
-3923129293532525183,10.0.2.15,142.251.36.74,443,tcp,tls,195,2204,13,2201,13,4405,26,normal,-
6499594738570585849,10.0.2.15,157.240.251.9,443,tcp,tls,432,4466,13,1460,12,5926,25,normal,-
-7586586726597305629,10.0.2.15,17.253.144.10,443,tcp,tls,539,5849,11,1610,11,7459,22,normal,-
-8892083872847785980,10.0.2.15,156.38.4.81,443,tcp,tls,780,4064,11,1352,10,5416,21,normal,-
4525228096273494100,10.0.2.15,157.240.30.18,443,tcp,tls,19436,3409,23,3314,21,6723,44,normal,-
-3962112997703949713,10.0.2.15,91.198.174.192,443,tcp,tls,226,5138,11,1422,11,6560,22,normal,-
-7578510938896998623,10.0.2.15,31.30.189.145,443,tcp,tls,832,4058,11,1406,11,5464,22,normal,-
7819407298306624995,10.0.2.15,104.18.25.196,443,tcp,-,1099,60,1,128,2,188,3,normal,-
3656101986799304462,10.0.2.15,91.198.174.208,443,tcp,tls,258,5282,13,1476,12,6758,25,normal,-
5939873213627781750,10.0.2.15,91.198.174.192,443,tcp,tls,237,5193,12,1476,12,6669,24,normal,-
-356132092767359948,10.0.2.15,31.30.189.145,443,tcp,tls,175,4226,14,1514,13,5740,27,normal,-
-4850352177269102673,10.0.2.15,104.19.188.97,443,tcp,-,67,60,1,128,2,188,3,normal,-
4058566449906895157,10.0.2.15,142.251.36.74,443,tcp,tls,164,2252,14,2256,14,4508,28,normal,-
3898163060335696932,10.0.2.15,65.9.95.23,443,tcp,-,88,60,1,128,2,188,3,normal,-
1122534833712984551,10.0.2.15,142.251.36.74,443,tcp,tls,161,2258,14,2148,12,4406,26,normal,-
-5031067172824096667,10.0.2.15,31.30.189.145,443,tcp,tls,371,4057,11,1352,10,5409,21,normal,-
1737606559766056007,10.0.2.15,91.198.174.192,443,tcp,tls,270,5222,12,1422,11,6644,23,normal,-
7369666235072303434,185.125.190.49,10.0.2.16,33768,tcp,-,51018,0,0,300,5,300,5,normal,-
-1011074041426371554,10.0.2.15,157.240.251.9,443,tcp,tls,257,4377,11,1406,11,5783,22,normal,-
5997813823761896661,10.0.2.15,142.251.36.74,443,tcp,tls,205,2150,12,2147,12,4297,24,normal,-
-7745021697816507377,10.0.2.15,31.30.189.145,443,tcp,-,1045,60,1,128,2,188,3,normal,-
-7359729513144928603,10.0.2.15,34.120.208.123,443,tcp,tls,550,4470,11,1197,12,5667,23,normal,-
-8542499758805226523,10.0.2.15,142.251.37.99,443,tcp,-,48,60,1,128,2,188,3,normal,-
-5915913559905055522,10.0.2.15,8.8.8.8,53,udp,dns,0,0,0,101,1,101,1,normal,-
492302827151127203,10.0.2.15,31.30.189.145,443,tcp,tls,624,4170,13,1514,13,5684,26,normal,-
-5845338127005584886,10.0.2.15,142.251.36.78,443,tcp,tls,277,8163,13,1514,13,9677,26,normal,-
5129534119276895840,10.0.2.15,142.251.37.110,443,tcp,tls,346,6400,16,2052,16,8452,32,normal,-
-8881148783517319566,10.0.2.15,31.30.189.145,443,tcp,-,134,60,1,128,2,188,3,normal,-
8682511683081040831,10.0.2.15,142.251.37.99,443,tcp,tls,262,5655,12,1460,12,7115,24,normal,-
-6999546354585481038,10.0.2.15,142.251.36.99,443,tcp,tls,207,5628,12,1460,12,7088,24,normal,-
4770352428743446097,10.0.2.15,104.16.57.101,443,tcp,tls,244,4086,11,1406,11,5492,22,normal,-
1228620271945385928,10.0.2.15,31.30.189.145,443,tcp,tls,171,4110,12,1460,12,5570,24,normal,-
2159635963864651970,10.0.2.15,142.251.36.132,443,tcp,-,44,60,1,128,2,188,3,normal,-
2104708217310232305,10.0.2.15,157.240.30.27,443,tcp,tls,261,35113,39,2475,25,37588,64,normal,-
1667952195793712090,10.0.2.15,186.192.81.5,443,tcp,tls,992,5269,11,1422,11,6691,22,normal,-
-1328898296325736563,10.0.2.15,142.251.36.74,443,tcp,tls,386,2150,12,2200,13,4350,25,normal,-
-8696699283999106062,10.0.2.15,179.60.195.12,443,tcp,tls,1303,5962,15,2192,15,8154,30,normal,-
-6481039060186926417,10.0.2.15,142.251.37.106,443,tcp,tls,436,8023,19,2190,18,10213,37,normal,-
8876647074571310380,10.0.2.15,31.30.189.145,443,tcp,tls,817,497857,381,25382,344,523239,725,normal,-
-1332772474170606656,10.0.2.15,31.30.189.145,443,tcp,tls,498,4170,13,1514,13,5684,26,normal,-
-4012247316141230669,10.0.2.15,142.251.36.74,443,tcp,tls,729,2096,11,2147,12,4243,23,normal,-
268643753165070189,10.0.2.15,92.88.3.20,443,tcp,tls,403,6057,18,2236,17,8293,35,normal,-
-6596486065639337852,10.0.2.15,52.97.135.98,443,tcp,tls,554,17753,26,2149,18,19902,44,normal,-
5977086124075834221,10.0.2.15,142.251.37.99,443,tcp,tls,269,5715,13,1514,13,7229,26,normal,-
-1070275230556154253,10.0.2.15,142.251.36.72,443,tcp,tls,432,132610,103,3887,51,136497,154,normal,-
7846436361437505146,10.0.2.15,54.187.99.131,443,tcp,tls,15956,5839,22,5367,19,11206,41,normal,-
-3095748388553509770,10.0.2.15,91.198.174.192,443,tcp,tls,299,5205,12,1422,11,6627,23,normal,-
-8765668056385875032,10.0.2.15,157.240.20.19,443,tcp,tls,300,6552,21,2289,18,8841,39,normal,-
7454848939529324671,10.0.2.15,146.75.122.109,443,tcp,tls,483,5913,15,1557,13,7470,28,normal,-
-120973815373758131,10.0.2.15,2.17.147.11,443,tcp,tls,5589,4581,12,1342,12,5923,24,normal,-
-975921261784349149,10.0.2.15,67.220.240.113,443,tcp,tls,24220,11672,26,10833,24,22505,50,normal,-
-740774270193975022,10.0.2.15,52.46.155.104,443,tcp,tls,21813,13570,20,3468,20,17038,40,normal,-
-7960068344177997783,10.0.2.15,142.251.36.130,443,tcp,tls,392,6595,18,2316,18,8911,36,normal,-
-5534654211823194744,10.0.2.15,34.120.208.123,443,tcp,tls,550,4470,11,1197,12,5667,23,normal,-
1841879076457999994,10.0.2.15,157.240.30.18,443,tcp,tls,14508,63969,118,11382,105,75351,223,normal,-
-4025626910066197831,10.0.2.15,157.240.30.18,443,tcp,tls,19169,1947,20,3163,19,5110,39,normal,-
-4995845820645585274,10.0.2.15,65.9.95.67,443,tcp,tls,171309,11063,24,2845,22,13908,46,normal,-
-7888628283512342285,10.0.2.15,216.239.32.36,443,tcp,tls,346,7098,24,3069,21,10167,45,normal,-
-2069041502307134542,10.0.2.15,54.239.29.0,443,tcp,tls,25454,10813,46,46582,47,57395,93,normal,-
-3234048706951814791,10.0.2.15,192.229.221.25,443,tcp,tls,62437,10304,23,2270,20,12574,43,normal,-
-6868229742828991217,10.0.2.15,65.9.95.43,443,tcp,tls,49064,7507,18,2146,18,9653,36,normal,-
-4634814061166291790,10.0.2.15,146.75.122.109,443,tcp,tls,53857,3295743,2324,49931,783,3345674,3107,normal,-
-8528759802390354814,10.0.2.15,95.100.146.27,443,tcp,tls,5335,6541,12,1343,13,7884,25,normal,-
-5640360734263608535,10.0.2.15,142.251.36.67,443,tcp,tls,141547,5966,16,1807,16,7773,32,normal,-
988573450406120177,10.0.2.15,216.239.32.36,443,tcp,tls,180,5971,12,1460,12,7431,24,normal,-
-4551033850622881530,10.0.2.15,35.244.142.80,443,tcp,tls,162,5130,8,1023,9,6153,17,normal,-
-590018401261978396,10.0.2.15,65.9.9.138,80,tcp,http,45561,3545,11,1967,12,5512,23,normal,-
5507160292128251055,10.0.2.15,34.199.38.96,443,tcp,tls,46374,7985,21,2816,19,10801,40,normal,-
-102724847040198913,10.0.2.15,151.101.194.137,443,tcp,tls,270,5888,13,1514,13,7402,26,normal,-
7368947423398401161,10.0.2.15,186.192.81.5,443,tcp,tls,104316,7482,16,2102,17,9584,33,normal,-
3777674411702859491,10.0.2.15,216.239.34.36,443,tcp,tls,597,6662,18,2396,17,9058,35,normal,-
-1142432020703857903,10.0.2.15,67.220.240.113,443,tcp,tls,27735,9367,22,8029,22,17396,44,normal,-
-6112741765854225965,10.0.2.15,146.75.122.109,443,tcp,tls,483,5913,15,1557,13,7470,28,normal,-
-3144245248919720692,10.0.2.15,104.19.188.97,443,tcp,tls,52330,36769,41,3302,31,40071,72,normal,-
-5788073308488250908,10.0.2.15,142.251.36.70,443,tcp,tls,548,7129,19,2369,19,9498,38,normal,-
-7764181327763303505,10.0.2.15,104.19.147.8,443,tcp,tls,48466,33386,35,3075,34,36461,69,normal,-
2940318343942087597,10.0.2.15,142.251.36.67,443,tcp,tls,434,6446,16,2029,16,8475,32,normal,-
-6170244252531502529,10.0.2.15,142.251.37.110,443,tcp,tls,946,7947,19,2396,20,10343,39,normal,-
1254651769367711328,10.0.2.15,195.8.215.136,443,tcp,tls,5010,7156,13,1397,14,8553,27,normal,-
-7957607252313632074,10.0.2.15,142.250.27.155,443,tcp,tls,290,6675,18,2261,17,8936,35,normal,-
6884889352985391637,10.0.2.15,104.16.137.206,443,tcp,tls,170779,27013,35,2453,23,29466,58,normal,-
5349487003898651856,10.0.2.15,34.120.202.204,443,tcp,tls,1417,7532,30,9185,29,16717,59,normal,-
-7538639213803418162,10.0.2.15,52.94.236.248,443,tcp,tls,6314,6583,12,1396,13,7979,25,normal,-
8945498417777545595,10.0.2.15,34.160.144.191,443,tcp,tls,115938,12093,24,2087,20,14180,44,normal,-
-746025459558594308,10.0.2.15,34.111.73.144,443,tcp,tls,279,5714,13,1265,13,6979,26,normal,-
1855006369165896115,10.0.2.15,104.19.154.83,443,tcp,tls,170473,4429,16,1807,16,6236,32,normal,-
-5089362622671941210,10.0.2.15,52.46.155.104,443,tcp,tls,1257,9200,15,2226,14,11426,29,normal,-
-8116231223461703778,10.0.2.15,142.251.36.99,443,tcp,tls,535,6550,18,2137,18,8687,36,normal,-
-1423103418231402464,10.0.2.15,52.46.132.119,443,tcp,tls,5931,6780,12,1396,13,8176,25,normal,-
-2794406668598333242,10.0.2.15,142.251.37.99,443,tcp,tls,795,12587,16,1676,16,14263,32,normal,-
191946715009216358,10.0.2.15,185.58.74.239,443,tcp,tls,15772,6673,13,1718,11,8391,24,normal,-
7324788306489531518,10.0.2.15,34.111.73.144,443,tcp,tls,266,5660,12,1265,13,6925,25,normal,-
5284666675000666047,10.0.2.15,142.251.36.132,443,tcp,tls,453,7366,20,2627,18,9993,38,normal,-
-2892469308220656425,10.0.2.15,35.244.142.80,443,tcp,tls,401,6483,17,2066,16,8549,33,normal,-
-8919140155495019854,10.0.2.15,23.195.248.219,443,tcp,tls,120334,31832,39,2627,26,34459,65,normal,-
323369777316502285,10.0.2.15,2.16.2.88,443,tcp,tls,48290,15640,23,2263,23,17903,46,normal,-
-2776733555052001823,10.0.2.15,52.46.154.73,443,tcp,tls,26858,7784,17,3280,17,11064,34,normal,-
3400176951900978293,10.0.2.15,65.9.94.149,443,tcp,tls,20150,7072,15,1675,15,8747,30,normal,-
-5602185412513914389,10.0.2.15,151.101.193.44,443,tcp,tls,166,4992,12,1460,12,6452,24,normal,-
6272765464290783908,10.0.2.15,13.107.21.200,443,tcp,tls,126987,9043,19,2501,18,11544,37,normal,-
-6010961240162206846,10.0.2.15,142.251.36.78,443,tcp,tls,376,10716,21,3938,19,14654,40,normal,-
1311423381757797863,10.0.2.15,151.101.192.176,443,tcp,tls,171670,24435,35,3058,29,27493,64,normal,-
-7141077851920250816,10.0.2.15,35.244.181.201,443,tcp,tls,116019,6013,18,1989,17,8002,35,normal,-
4781631506900794751,10.0.2.15,142.251.36.132,443,tcp,tls,142467,5933,16,1807,16,7740,32,normal,-
-6835489415382504970,10.0.2.15,34.160.144.191,443,tcp,tls,39608,11883,21,2097,21,13980,42,normal,-
6208819178938028773,10.0.2.15,95.100.146.74,443,tcp,tls,31613,8085,33,6871,30,14956,63,normal,-
-7711314737010705239,10.0.2.15,157.240.221.16,443,tcp,tls,1313,6221,17,2242,16,8463,33,normal,-
-2953316111175220259,10.0.2.15,157.240.30.35,443,tcp,tls,172,4423,12,1406,11,5829,23,normal,-
-6697595816236067259,10.0.2.15,176.34.155.112,443,tcp,tls,46520,7014,19,2372,19,9386,38,normal,-
-8786271018775190903,10.0.2.15,142.251.37.110,443,tcp,tls,866,27748,30,2311,22,30059,52,normal,-
-6902877139644931617,10.0.2.15,65.9.95.44,443,tcp,tls,105,3164,6,861,6,4025,12,normal,-
-1071986573095513284,10.0.2.15,142.251.37.99,443,tcp,tls,56050,5775,14,1621,14,7396,28,normal,-
5348759926957212939,10.0.2.15,162.247.241.14,443,tcp,tls,49627,7038,24,13352,25,20390,49,normal,-
3306542409096985419,10.0.2.15,65.9.95.44,443,tcp,tls,49033,15336,24,2638,21,17974,45,normal,-
-7892287062011108110,10.0.2.15,18.195.122.2,443,tcp,tls,557,6261,12,1311,12,7572,24,normal,-
-5569752255118218511,10.0.2.15,91.198.174.208,443,tcp,tls,259,5282,13,1476,12,6758,25,normal,-
9052644019307685003,10.0.2.15,151.101.193.35,443,tcp,tls,3901,6344,19,4213,18,10557,37,normal,-
7737241448412648342,10.0.2.15,64.4.250.36,443,tcp,tls,9961,5277,15,2296,15,7573,30,normal,-
-1851055408322170034,10.0.2.15,54.76.54.26,443,tcp,tls,46656,7070,19,2224,19,9294,38,normal,-
-5971483943993895500,10.0.2.15,142.251.36.78,443,tcp,tls,171050,8643,20,2077,21,10720,41,normal,-
-3652527126994125509,10.0.2.15,65.9.94.149,443,tcp,tls,479,3268,6,861,6,4129,12,normal,-
-5526494633055625771,10.0.2.15,65.9.95.107,443,tcp,tls,40464,646682,525,26012,329,672694,854,normal,-
8373227919722222392,10.0.2.15,104.244.42.133,443,tcp,tls,161642,4801,20,2558,20,7359,40,normal,-
-8783291667101354125,10.0.2.15,157.240.30.35,443,tcp,tls,170959,8018,37,10361,33,18379,70,normal,-
8781557582413539592,10.0.2.15,107.23.234.169,443,tcp,tls,877,6479,12,1590,13,8069,25,normal,-
-1567326893714472195,10.0.2.15,151.101.193.51,443,tcp,tls,23703,7546,20,2906,19,10452,39,normal,-
4213777007848034526,10.0.2.15,151.101.193.44,443,tcp,tls,47540,26795,32,3525,31,30320,63,normal,-
6186027817953985122,10.0.2.15,142.251.37.98,443,tcp,tls,170416,6068,18,1969,19,8037,37,normal,-
-2759555982930373626,10.0.2.15,142.251.36.98,443,tcp,tls,358,8901,19,2265,18,11166,37,normal,-
-4376767644395879065,10.0.2.15,142.251.37.99,443,tcp,tls,84115,65726,63,3467,35,69193,98,normal,-
-8878638738659813593,10.0.2.15,193.189.143.34,443,tcp,tls,19810,7757,15,1745,16,9502,31,normal,-
2153364807215769828,10.0.2.15,95.100.146.50,443,tcp,tls,30667,6977,23,2630,20,9607,43,normal,-
8032836023714145962,10.0.2.15,34.120.202.204,443,tcp,tls,318,6055,12,1514,13,7569,25,normal,-
4449289160445601537,10.0.2.15,2.17.147.75,443,tcp,tls,672,3164,6,861,6,4025,12,normal,-
2042108139334058170,10.0.2.15,65.9.95.89,443,tcp,tls,6223,6273,11,1273,12,7546,23,normal,-
-5184614768541772038,10.0.2.15,2.17.147.56,443,tcp,tls,210,3164,6,861,6,4025,12,normal,-
2662799705665442534,10.0.2.15,65.9.94.96,443,tcp,tls,22738,12692,19,2152,17,14844,36,normal,-
-6904600929983534910,10.0.2.15,162.159.128.61,443,tcp,tls,52617,167045,143,21627,95,188672,238,normal,-
7472874955106142316,10.0.2.15,13.107.42.14,443,tcp,tls,127414,9729,24,2929,23,12658,47,normal,-
-7809450838917207526,10.0.2.15,65.9.95.67,443,tcp,tls,194,5066,12,1140,11,6206,23,normal,-
4002417099051307047,10.0.2.15,65.9.99.47,443,tcp,tls,28954,5039465,3803,89704,1005,5129169,4808,normal,-
5618167322306479381,10.0.2.15,107.23.234.169,443,tcp,tls,877,6533,13,1644,14,8177,27,normal,-
-5841632846590661838,10.0.2.15,142.251.37.99,443,tcp,tls,1376,14084,21,2374,20,16458,41,normal,-
5154830560542267790,10.0.2.15,91.198.174.208,443,tcp,tls,293,5221,12,1422,11,6643,23,normal,-
5432191980711017043,10.0.2.15,34.117.65.55,443,tcp,tls,171007,6252,18,1969,19,8221,37,normal,-
4314769556599884679,10.0.2.15,192.229.221.25,443,tcp,tls,1457,7747,13,1476,12,9223,25,normal,-
5781042759652252975,10.0.2.15,50.17.141.61,443,tcp,tls,48866,7155,20,2347,20,9502,40,normal,-
-8757768222114906674,10.0.2.15,65.9.95.108,443,tcp,tls,47466,7612,17,2070,17,9682,34,normal,-
-1972386849188764253,10.0.2.15,65.9.9.67,443,tcp,tls,155861,7478,20,2023,20,9501,40,normal,-
-4962802901623832944,10.0.2.15,185.199.110.154,443,tcp,tls,216,4978,12,1460,12,6438,24,normal,-
-5921318523532909935,10.0.2.15,142.251.36.130,443,tcp,tls,170484,6297,18,1915,18,8212,36,normal,-
-4361107156236811387,10.0.2.15,74.115.50.110,443,tcp,tls,11561,9265,17,1907,15,11172,32,normal,-
4422704929339922084,10.0.2.15,104.18.135.59,443,tcp,tls,170652,5594,20,2275,20,7869,40,normal,-
-4846414900790326780,10.0.2.15,104.18.25.196,443,tcp,tls,171236,21396,29,2326,21,23722,50,normal,-
3372896347784077256,10.0.2.15,52.46.132.119,443,tcp,tls,21412,7303,14,2581,14,9884,28,normal,-
-5537072541305898318,10.0.2.15,142.251.36.99,443,tcp,tls,262,6714,18,2518,16,9232,34,normal,-
2555541043063243221,10.0.2.15,52.94.243.89,443,tcp,tls,28713,7357,16,2018,16,9375,32,normal,-
362431744904136712,10.0.2.15,34.120.208.123,443,tcp,tls,550,4524,12,1197,12,5721,24,normal,-
4773967222298211823,10.0.2.15,162.159.128.61,443,tcp,tls,52561,8295,22,7682,21,15977,43,normal,-
-8828621711471298623,10.0.2.15,151.101.193.21,443,tcp,tls,8158,46139,46,4266,30,50405,76,normal,-
3532503059352878816,10.0.2.15,67.220.240.113,443,tcp,tls,22693,9320,19,5049,18,14369,37,normal,-
-5421250914793147559,10.0.2.15,140.82.121.5,443,tcp,tls,100622,6780,44,39750,43,46530,87,normal,-
-7201795616838001332,10.0.2.15,147.229.2.90,443,tcp,tls,9183,367717,319,23104,196,390821,515,normal,-
-1828439088191060439,10.0.2.15,65.9.95.30,443,tcp,tls,50572,8423,27,8553,27,16976,54,normal,-
-3276002969156675042,10.0.2.15,192.229.221.25,443,tcp,tls,1458,7747,13,1476,12,9223,25,normal,-
3484464683669644912,10.0.2.15,54.239.26.205,443,tcp,tls,21856,7468,14,2300,14,9768,28,normal,-
7092247451487173532,10.0.2.15,146.75.122.109,443,tcp,tls,483,5913,15,1557,13,7470,28,normal,-
-2592267337968949330,10.0.2.15,162.159.128.61,443,tcp,tls,54974,117349,126,35708,89,153057,215,normal,-
5141576136414124810,10.0.2.15,91.198.174.192,443,tcp,tls,163,1642,4,807,5,2449,9,normal,-
4837145306387949080,10.0.2.15,185.199.110.154,443,tcp,tls,234,4919,12,1460,12,6379,24,normal,-
728997101691422606,10.0.2.15,162.159.128.61,443,tcp,tls,41972,21894,28,5779,24,27673,52,normal,-
7512526383830108285,10.0.2.15,104.18.16.5,443,tcp,tls,40383,100269,79,3026,35,103295,114,normal,-
4990371773470758757,10.0.2.15,142.251.36.132,443,tcp,tls,187345,7729,30,3272,30,11001,60,normal,-
9168350312575801243,10.0.2.15,142.250.27.156,443,tcp,tls,278,6556,19,2233,18,8789,37,normal,-
-4615655304990033260,10.0.2.15,185.199.110.154,443,tcp,tls,207,4858,10,1406,11,6264,21,normal,-
1074125535043271715,10.0.2.15,54.239.29.0,443,tcp,tls,1568,8336,15,2692,14,11028,29,normal,-
8842347651740302608,10.0.2.15,142.251.37.99,443,tcp,tls,260,5654,12,1460,12,7114,24,normal,-
-3635354517849190558,10.0.2.15,147.229.2.90,443,tcp,tls,8393,1483604,1066,33174,446,1516778,1512,normal,-
6696359308274724274,10.0.2.15,198.143.164.252,443,tcp,tls,60366,5536,18,1768,16,7304,34,normal,-
5999005300860515879,10.0.2.15,104.244.42.67,443,tcp,tls,161344,5004,21,2591,21,7595,42,normal,-
-7594355318404975342,10.0.2.15,162.247.241.14,443,tcp,tls,49873,6732,19,4119,20,10851,39,normal,-
9190783042684931146,10.0.2.15,156.38.4.81,443,tcp,tls,1499,6120,20,2444,19,8564,39,normal,-
8002528976569573414,10.0.2.15,162.247.241.14,443,tcp,tls,49680,7212,27,15850,28,23062,55,normal,-
4334464195026151789,10.0.2.15,142.251.36.132,443,tcp,tls,475,6529,18,2339,17,8868,35,normal,-
6736233073959233447,10.0.2.15,2.17.147.9,443,tcp,tls,40912,2354821,1618,32962,548,2387783,2166,normal,-
8465498618465888265,10.0.2.15,186.192.90.12,443,tcp,tls,1205,5979,13,1584,14,7563,27,normal,-
673824846900476220,10.0.2.15,162.247.241.14,443,tcp,tls,49142,9424,30,14304,31,23728,61,normal,-
-5504540154199407866,10.0.2.15,142.251.36.74,443,tcp,tls,1054,2210,13,2224,13,4434,26,normal,-
6028095003769873219,10.0.2.15,65.9.95.89,443,tcp,tls,23053,338412,241,7386,117,345798,358,normal,-
5579378017785768260,10.0.2.15,142.251.36.150,443,tcp,tls,401,10298,21,2258,19,12556,40,normal,-
-8018487095748916089,10.0.2.15,95.100.146.25,443,tcp,tls,39549,7243,17,2110,18,9353,35,normal,-
103188194555715851,10.0.2.15,65.9.95.49,443,tcp,tls,52539,155638,129,6705,90,162343,219,normal,-
2986281670568737747,10.0.2.15,13.107.42.14,443,tcp,tls,50428,13220,29,3684,28,16904,57,normal,-
5098090484074900701,10.0.2.15,142.250.27.154,443,tcp,tls,170400,6350,19,1915,18,8265,37,normal,-
4709546927007941995,10.0.2.15,107.23.234.169,443,tcp,tls,27088,18476,99,59403,98,77879,197,normal,-
-5110208565442994923,10.0.2.15,142.251.36.130,443,tcp,tls,668,8090,18,2313,17,10403,35,normal,-
-2186654721615653584,10.0.2.15,95.100.146.40,443,tcp,tls,121062,10206,25,2687,25,12893,50,normal,-
3256503008578885424,10.0.2.15,67.220.240.113,443,tcp,tls,22827,10066,22,8560,22,18626,44,normal,-
-6788876574891712747,10.0.2.15,23.195.249.197,443,tcp,tls,107277,10262,23,2249,20,12511,43,normal,-
-7372654022900145393,10.0.2.15,140.82.121.3,443,tcp,tls,102314,65187,64,3756,34,68943,98,normal,-
7301866229657552439,10.0.2.15,142.251.36.130,443,tcp,tls,260,9776,23,2713,19,12489,42,normal,-
-7745143596256377166,10.0.2.15,52.46.132.119,443,tcp,tls,22060,7363,15,2445,15,9808,30,normal,-
658567944328583821,10.0.2.15,18.195.122.2,443,tcp,tls,39786,6949,18,2276,18,9225,36,normal,-
230702576073847661,10.0.2.15,107.23.234.169,443,tcp,tls,937,6653,15,1698,15,8351,30,normal,-
-2659421657369946683,10.0.2.15,65.9.95.108,443,tcp,tls,171991,6496,23,2805,24,9301,47,normal,-
-319552741018860941,10.0.2.15,91.198.174.192,443,tcp,tls,156623,8747,25,2659,24,11406,49,normal,-
86550240278242388,10.0.2.15,2.16.2.192,443,tcp,tls,47822,11056,22,2170,19,13226,41,normal,-
8122561595769872396,10.0.2.15,142.251.36.78,443,tcp,tls,351,8163,13,1514,13,9677,26,normal,-
-8264468530585469112,10.0.2.15,192.229.221.25,443,tcp,tls,1463,7743,13,1476,12,9219,25,normal,-
6138233733282005387,10.0.2.15,54.239.26.205,443,tcp,tls,21843,13690,19,3316,20,17006,39,normal,-
7528506493511722029,10.0.2.15,192.229.221.25,443,tcp,tls,1471,7981,17,1692,16,9673,33,normal,-
-8440482943279645571,10.0.2.15,34.120.15.67,443,tcp,tls,601,6753,19,3107,20,9860,39,normal,-
295122871364117489,10.0.2.15,162.159.128.61,443,tcp,tls,53843,5196,21,7529,21,12725,42,normal,-
5441462612346223284,10.0.2.15,162.159.128.61,443,tcp,tls,40850,11162,20,3748,19,14910,39,normal,-
619371736089570741,10.0.2.15,65.9.95.80,443,tcp,tls,20486,11830,20,2371,19,14201,39,normal,-
3366534945276598729,10.0.2.15,157.240.30.3,443,tcp,tls,19394,10543,135,68331,123,78874,258,normal,-
4224838154250943065,10.0.2.15,142.251.36.74,443,tcp,tls,651,2150,12,2200,13,4350,25,normal,-
2561600905610473958,10.0.2.15,142.251.36.130,443,tcp,tls,242,5870,12,1460,12,7330,24,normal,-
634878652526223337,10.0.2.15,185.199.110.154,443,tcp,tls,101011,230791,174,6691,96,237482,270,normal,-
-485625272381854638,10.0.2.15,142.251.36.130,443,tcp,tls,213,5870,12,1460,12,7330,24,normal,-
-7114178083503700538,10.0.2.15,146.75.116.157,443,tcp,tls,170779,5827,21,2357,19,8184,40,normal,-
-5057731803001766602,10.0.2.15,13.226.89.127,443,tcp,tls,30146,309469,258,17268,149,326737,407,normal,-
6815976827335827028,10.0.2.15,192.229.221.25,443,tcp,tls,6271,76241,65,3160,32,79401,97,normal,-
-5283604010030477820,10.0.2.15,52.46.153.141,443,tcp,tls,1042,7743,15,2008,14,9751,29,normal,-
-4186887326817483950,10.0.2.15,2.17.147.11,443,tcp,tls,2120,1642,4,807,5,2449,9,normal,-
-5228540103425414474,10.0.2.15,142.251.36.74,443,tcp,tls,126,2198,13,2148,12,4346,25,normal,-
-4915255703467772279,10.0.2.15,151.101.193.35,443,tcp,tls,796,5101,12,1460,12,6561,24,normal,-
7296018067627393133,10.0.2.15,192.229.221.25,443,tcp,tls,1212,7743,13,1476,12,9219,25,normal,-
-5061367591332138205,10.0.2.15,151.101.193.16,443,tcp,tls,29373,631927,490,26995,387,658922,877,normal,-
-582523240398043871,10.0.2.15,151.101.193.16,443,tcp,tls,1461,6259,11,1460,12,7719,23,normal,-
-8506092309844239972,10.0.2.15,95.100.146.34,443,tcp,tls,47943,186107,152,8092,87,194199,239,normal,-
-7531537152033114873,10.0.2.15,44.235.139.122,443,tcp,tls,36885,5552,17,2775,16,8327,33,normal,-
-8403665596506151693,10.0.2.15,2.17.147.16,443,tcp,tls,1108,76766,62,3533,28,80299,90,normal,-
8028793696333887636,10.0.2.15,104.19.147.8,443,tcp,tls,46767,7316,18,2136,16,9452,34,normal,-
-140361351514497657,10.0.2.15,65.9.95.66,443,tcp,tls,154863,7922,21,2396,22,10318,43,normal,-
-4184431475262455220,10.0.2.15,104.19.188.97,443,tcp,tls,53606,95800,79,3050,31,98850,110,normal,-
9032500934729985531,10.0.2.15,142.251.36.132,443,tcp,tls,297,6669,18,2224,17,8893,35,normal,-
-808179775389648965,10.0.2.15,142.251.36.131,443,tcp,tls,423,6126,17,2056,16,8182,33,normal,-
-3774174313273113492,10.0.2.15,65.9.95.26,443,tcp,tls,686,7002,13,1568,14,8570,27,normal,-
-4221717639188840216,10.0.2.15,157.240.30.18,443,tcp,tls,170832,4930,19,1915,18,6845,37,normal,-
2601317655185171941,10.0.2.15,142.251.36.132,443,tcp,tls,357,5568,11,1460,12,7028,23,normal,-
8430932098537184005,10.0.2.15,65.9.99.47,443,tcp,tls,1415,6184,12,1514,13,7698,25,normal,-
-15435226648726842,10.0.2.15,95.100.146.27,443,tcp,tls,5336,6661,14,1397,14,8058,28,normal,-
4943953862821666506,10.0.2.15,142.251.36.74,443,tcp,tls,165,2144,12,2148,12,4292,24,normal,-
7678868537291184309,10.0.2.15,157.240.30.3,443,tcp,tls,170721,5444,26,2194,21,7638,47,normal,-
-4031874646072179833,10.0.2.15,142.251.36.99,443,tcp,tls,397,9444,19,3350,18,12794,37,normal,-
-5104785594179319420,10.0.2.15,172.64.144.98,443,tcp,tls,51576,5308,18,2307,18,7615,36,normal,-
1616901099895492402,10.0.2.15,157.240.30.35,443,tcp,tls,2094,353142,264,14151,236,367293,500,normal,-
2005296496228140060,10.0.2.15,157.240.251.9,443,tcp,tls,171798,1380335,991,34392,547,1414727,1538,normal,-
5134293339199228870,10.0.2.15,65.9.97.248,443,tcp,tls,50798,22003,29,2790,29,24793,58,normal,-
642636176031509183,10.0.2.15,34.111.73.144,443,tcp,tls,36885,62754,97,7977,68,70731,165,normal,-
6766680109780668643,10.0.2.15,157.240.30.27,443,tcp,tls,174,4375,11,1352,10,5727,21,normal,-
4236038258772013391,10.0.2.15,65.9.99.47,443,tcp,tls,1414,6184,12,1514,13,7698,25,normal,-
-1627807554436373732,10.0.2.15,52.212.190.143,443,tcp,tls,46941,7326,20,3702,20,11028,40,normal,-
8181504684500001848,10.0.2.15,146.75.122.109,443,tcp,tls,455,5913,15,1557,13,7470,28,normal,-
2369818658557622180,10.0.2.15,200.147.3.157,443,tcp,tls,116601,5182,23,2595,23,7777,46,normal,-
5947425484175334617,10.0.2.15,52.35.72.159,443,tcp,tls,844,6202,9,1203,10,7405,19,normal,-
8289072354689381150,10.0.2.15,142.251.36.78,443,tcp,tls,248,8161,13,1514,13,9675,26,normal,-
-5130624818300052318,10.0.2.15,31.13.84.4,443,tcp,tls,385,6478,18,2191,16,8669,34,normal,-
6192208828091448945,10.0.2.15,162.159.128.61,443,tcp,tls,52509,9642,24,9846,25,19488,49,normal,-
8458823828205641288,10.0.2.15,186.192.90.12,443,tcp,tls,105725,6628,17,2153,18,8781,35,normal,-
6962186818447380379,10.0.2.15,34.111.73.144,443,tcp,tls,267,5834,15,1265,13,7099,28,normal,-
-1692563509219401344,10.0.2.15,34.199.38.96,443,tcp,tls,5837,6375,13,1396,13,7771,26,normal,-
6872580586026982981,10.0.2.15,34.107.204.85,443,tcp,tls,170578,6435,19,2023,20,8458,39,normal,-
-1964450978734237542,10.0.2.15,67.220.240.113,443,tcp,tls,22626,9331,20,6671,21,16002,41,normal,-
8793359263730986016,10.0.2.15,34.111.73.144,443,tcp,tls,267,5780,14,1265,13,7045,27,normal,-
4791653923119150099,10.0.2.15,23.195.249.173,443,tcp,tls,120539,26968,37,2936,31,29904,68,normal,-
-2580296993124074499,10.0.2.15,65.9.95.118,443,tcp,tls,53420,9630,21,2529,21,12159,42,normal,-
8413479556323430507,10.0.2.15,142.251.36.67,443,tcp,tls,157265,6201,20,2402,21,8603,41,normal,-
-4277721745063380304,10.0.2.15,107.23.234.169,443,tcp,tls,886,6501,13,1644,14,8145,27,normal,-
-5485554086704895693,10.0.2.15,13.107.21.200,443,tcp,tls,50358,23138,40,4915,40,28053,80,normal,-
-6116948602089561345,10.0.2.15,67.220.240.113,443,tcp,tls,22448,9313,21,8089,22,17402,43,normal,-
-113875283434875390,10.0.2.15,142.251.36.78,443,tcp,tls,142191,9452,24,2545,22,11997,46,normal,-
2546264318167973895,10.0.2.15,54.239.26.205,443,tcp,tls,6322,6736,12,1396,13,8132,25,normal,-
-2638586323320042147,10.0.2.15,95.100.146.34,443,tcp,tls,221,4067,12,1530,13,5597,25,normal,-
-3208488320025232979,10.0.2.15,104.17.113.188,443,tcp,tls,19247,4527,14,1826,13,6353,27,normal,-
-7528553684479515890,10.0.2.15,65.9.99.47,443,tcp,tls,766,6153,12,1514,13,7667,25,normal,-
-1880895141789366591,10.0.2.15,146.75.122.109,443,tcp,tls,483,5913,15,1557,13,7470,28,normal,-
7554739173277512030,10.0.2.15,142.251.36.74,443,tcp,tls,561,2204,13,2148,12,4352,25,normal,-
-7203206248809373492,10.0.2.15,151.101.0.81,443,tcp,tls,351,7903,19,2098,18,10001,37,normal,-
1456131415386107675,10.0.2.15,35.241.9.150,443,tcp,tls,190409,134745,132,8378,106,143123,238,normal,-
-1490748175257590264,10.0.2.15,104.17.131.110,443,tcp,tls,171282,98670,82,3210,37,101880,119,normal,-
-968102642108650196,10.0.2.15,104.17.209.240,443,tcp,tls,4312,15853,24,2424,19,18277,43,normal,-
5681428374153228943,10.0.2.15,65.9.95.43,443,tcp,tls,130,3268,6,861,6,4129,12,normal,-
-4182242888575513896,10.0.2.15,142.251.36.99,443,tcp,tls,319,6487,18,2164,17,8651,35,normal,-
3775595861369740695,10.0.2.15,65.9.95.87,443,tcp,tls,94575,35785,41,2818,28,38603,69,normal,-
2067384193296692951,10.0.2.15,146.75.122.109,443,tcp,tls,54263,179298,148,9391,135,188689,283,normal,-
-6245988037404668983,10.0.2.15,151.101.193.16,443,tcp,tls,3017,6344,13,1514,13,7858,26,normal,-
-7356289006780012268,10.0.2.15,140.82.112.22,443,tcp,tls,100520,5517,20,2978,20,8495,40,normal,-
-5636006869782462639,10.0.2.15,142.251.36.132,443,tcp,tls,365,5567,11,1460,12,7027,23,normal,-
3962488258688467750,10.0.2.15,142.251.36.78,443,tcp,tls,428,10432,21,2235,17,12667,38,normal,-
1992921426426296223,10.0.2.15,52.46.155.104,443,tcp,tls,6386,6691,12,1396,13,8087,25,normal,-
-5501475272032711652,10.0.2.15,151.101.193.26,443,tcp,tls,348,6946,18,2086,17,9032,35,normal,-
-5969987986630675591,10.0.2.15,151.101.193.16,443,tcp,tls,591,6259,11,1460,12,7719,23,normal,-
-7892539701701847148,10.0.2.15,142.251.36.99,443,tcp,tls,3184,182957,138,5770,83,188727,221,normal,-
-5635933645590695879,10.0.2.15,151.101.194.137,443,tcp,tls,51356,44370,51,3794,32,48164,83,normal,-
2094638086932662220,10.0.2.15,65.9.95.118,443,tcp,tls,53863,11058,37,5424,35,16482,72,normal,-
-8158780318766151469,10.0.2.15,31.30.189.145,443,tcp,tls,170735,84843,88,5192,45,90035,133,normal,-
-4436942103496211376,10.0.2.15,142.251.36.70,443,tcp,tls,162,3148,6,861,6,4009,12,normal,-
-3109492210237166288,10.0.2.15,192.229.221.25,443,tcp,tls,6272,281053,220,10169,139,291222,359,normal,-
4445754251724946441,10.0.2.15,65.9.95.74,443,tcp,tls,47234,20811,25,2097,18,22908,43,normal,-
-8599989875088851753,10.0.2.15,151.101.192.81,443,tcp,tls,216,7044,14,1568,14,8612,28,normal,-
-7449228615862959072,10.0.2.15,142.251.37.109,443,tcp,tls,156144,6082,18,1969,19,8051,37,normal,-
3092364036126296945,10.0.2.15,34.111.73.144,443,tcp,tls,269,5660,12,1265,13,6925,25,normal,-
4748407136545022695,10.0.2.15,65.9.95.118,443,tcp,tls,168,6915,13,1514,13,8429,26,normal,-
3013887382101418654,10.0.2.15,65.9.99.47,443,tcp,tls,1428,6184,12,1514,13,7698,25,normal,-
-3818487712664408454,10.0.2.15,157.240.251.60,443,tcp,tls,156746,4566,18,1861,17,6427,35,normal,-
2874357800667246592,10.0.2.15,142.251.36.74,443,tcp,tls,609,2486,12,2202,13,4688,25,normal,-
-8783243415398228136,10.0.2.15,162.159.128.61,443,tcp,tls,40676,13974,23,3867,23,17841,46,normal,-
3699013818272387570,10.0.2.15,67.220.240.113,443,tcp,tls,22651,8536,17,4451,18,12987,35,normal,-
-3596533659856867233,10.0.2.15,13.226.89.127,443,tcp,tls,809,6452,12,1460,12,7912,24,normal,-
-4697917418264048570,10.0.2.15,52.46.132.119,443,tcp,tls,21119,7303,14,2585,14,9888,28,normal,-
-5679533848685803859,10.0.2.15,142.251.37.104,443,tcp,tls,392,148892,115,4506,62,153398,177,normal,-
-1088326179792790044,10.0.2.15,192.229.221.25,443,tcp,tls,1212,7743,13,1530,13,9273,26,normal,-
-995458991864349205,10.0.2.15,34.117.65.55,443,tcp,tls,183500,1873,12,2208,12,4081,24,normal,-
2314127635557925982,10.0.2.15,142.251.36.99,443,tcp,tls,171137,6053,18,1969,19,8022,37,normal,-
9193348599761110377,10.0.2.15,142.251.36.74,443,tcp,tls,137,2198,13,2203,13,4401,26,normal,-
7684215184643116627,10.0.2.15,157.240.251.9,443,tcp,tls,344,4519,14,1568,14,6087,28,normal,-
-7842392002445680345,10.0.2.15,216.239.36.54,443,tcp,tls,8997,14733,29,3472,27,18205,56,normal,-
-5924896474364718903,10.0.2.15,157.240.30.35,443,tcp,tls,209,5033,18,2100,15,7133,33,normal,-
3116759021428657907,10.0.2.15,90.182.114.17,443,tcp,tls,376,5799,19,2293,18,8092,37,normal,-
-7225984253053068019,10.0.2.15,142.251.36.74,443,tcp,tls,213,2312,15,2255,14,4567,29,normal,-
-5873168260077879564,10.0.2.15,34.107.204.85,443,tcp,tls,346,6009,13,1568,14,7577,27,normal,-
5931697803678536732,10.0.2.15,107.23.234.169,443,tcp,tls,937,6555,14,1698,15,8253,29,normal,-
9003852057257121145,10.0.2.15,162.159.128.61,443,tcp,tls,41968,23518,30,5974,25,29492,55,normal,-
-9197550832749298967,10.0.2.15,157.240.30.35,443,tcp,tls,153,4314,11,1406,11,5720,22,normal,-
1605815429469153116,10.0.2.15,91.198.174.192,443,tcp,tls,129394,616178,483,21811,269,637989,752,normal,-
3649734959835582989,10.0.2.15,157.240.251.9,443,tcp,tls,798,4519,14,1568,14,6087,28,normal,-
605298682323089706,10.0.2.15,185.199.110.154,443,tcp,tls,102366,354411,276,10586,149,364997,425,normal,-
-4796292142704324190,10.0.2.15,185.199.110.154,443,tcp,tls,215,4834,10,1406,11,6240,21,normal,-
-7440331934493126346,10.0.2.15,149.154.167.99,443,tcp,tls,107777,12090,22,2419,23,14509,45,normal,-
3718778226560543973,10.0.2.15,35.241.9.150,443,tcp,tls,1548,5604,12,1204,12,6808,24,normal,-
-2034397313522789734,10.0.2.15,65.9.95.80,443,tcp,tls,1090,6497,12,1514,13,8011,25,normal,-
-2792662909381940326,10.0.2.15,65.9.95.89,443,tcp,tls,23401,34284,33,2820,33,37104,66,normal,-
-7529528759242759576,10.0.2.15,65.9.95.7,443,tcp,tls,49110,9740,23,2670,23,12410,46,normal,-
-4729558613584338100,10.0.2.15,194.228.230.20,443,tcp,tls,448,5788,19,2348,19,8136,38,normal,-
6458229023077917579,10.0.2.15,151.101.193.21,443,tcp,tls,63567,9222,21,2416,20,11638,41,normal,-
-2749472446586349282,10.0.2.15,91.198.174.208,443,tcp,tls,290,5168,11,1368,10,6536,21,normal,-
-6743976582363871261,10.0.2.15,54.239.29.0,443,tcp,tls,26561,19244,187,253459,186,272703,373,normal,-
7226250483541263026,10.0.2.15,157.240.251.9,443,tcp,tls,795,4522,14,1568,14,6090,28,normal,-
-5482513309518025711,10.0.2.15,35.244.181.201,443,tcp,tls,584,4640,13,1183,12,5823,25,normal,-
-6265440746244153887,10.0.2.15,185.199.110.154,443,tcp,tls,234,4978,12,1460,12,6438,24,normal,-
-3216220092464930310,10.0.2.15,65.9.99.47,443,tcp,tls,720,6178,12,1514,13,7692,25,normal,-
-4934467695315202506,10.0.2.15,162.159.128.61,443,tcp,tls,42114,2697,15,3851,15,6548,30,normal,-
-6577284588423423361,10.0.2.15,216.239.36.54,443,tcp,tls,400,12581,16,1676,16,14257,32,normal,-
-3706153503734330509,10.0.2.15,95.100.146.25,443,tcp,tls,40729,19806,38,5168,29,24974,67,normal,-
7775886319731301049,10.0.2.15,104.17.50.95,443,tcp,tls,170883,4587,18,1915,18,6502,36,normal,-
8893520106579916858,10.0.2.15,34.117.237.239,443,tcp,tls,171788,6931,23,2518,24,9449,47,normal,-
-2179239394706146201,10.0.2.15,3.224.56.55,443,tcp,tls,5941,8047,27,10243,27,18290,54,normal,-
-8123562878981197815,10.0.2.15,91.198.174.192,443,tcp,tls,257,5131,11,1422,11,6553,22,normal,-
4725061338351451598,10.0.2.15,34.160.144.191,443,tcp,tls,324,5543,12,1202,12,6745,24,normal,-
1009386070934473484,10.0.2.15,104.20.150.16,443,tcp,tls,37731,4592,14,1935,14,6527,28,normal,-
-1564852000513818504,10.0.2.15,91.198.174.208,443,tcp,tls,291,5223,12,1422,11,6645,23,normal,-
3782898069943998179,10.0.2.15,162.159.128.61,443,tcp,tls,6322,632,7,1228,9,1860,16,normal,-
7351405356275086839,10.0.2.15,65.9.95.49,443,tcp,tls,52605,90693,77,3788,44,94481,121,normal,-
-317860201559262056,10.0.2.15,142.251.36.110,443,tcp,tls,170996,8588,19,2023,20,10611,39,normal,-
-7280638742173777831,10.0.2.15,54.239.29.0,443,tcp,tls,5458,6870,12,1396,13,8266,25,normal,-
2849690035596988433,10.0.2.15,34.120.208.123,443,tcp,tls,184630,32447,197,74950,167,107397,364,normal,-
4529571121867824846,10.0.2.15,142.251.36.142,443,tcp,tls,170996,8589,19,2023,20,10612,39,normal,-
3572659920220856047,10.0.2.15,192.229.221.25,443,tcp,tls,1054,7747,13,1476,12,9223,25,normal,-
1809381162082160613,10.0.2.15,65.9.95.26,443,tcp,tls,24230,16388,28,5401,28,21789,56,normal,-
-5206008748023066549,10.0.2.15,65.9.94.221,443,tcp,tls,20780,7603,18,2155,18,9758,36,normal,-
2170269579004457724,10.0.2.15,65.9.95.7,443,tcp,tls,49467,10164,28,4264,27,14428,55,normal,-
2115834376617705869,10.0.2.15,95.100.146.50,443,tcp,tls,166,4031,7,969,8,5000,15,normal,-
8919967805585510536,10.0.2.15,67.220.240.113,443,tcp,tls,24354,11057,26,9620,27,20677,53,normal,-
-2494844406805143229,10.0.2.15,142.251.36.74,443,tcp,tls,343,2204,13,2201,13,4405,26,normal,-
-1591327200502961150,10.0.2.15,156.40.212.210,443,tcp,tls,2136,6712,12,1396,13,8108,25,normal,-
-4959025879706904834,10.0.2.15,104.16.57.101,443,tcp,tls,183627,8147,65,48840,64,56987,129,normal,-
-5620055375593930637,10.0.2.15,54.246.109.170,443,tcp,tls,47208,7345,19,2312,18,9657,37,normal,-
3380060699970352172,10.0.2.15,192.0.72.29,443,tcp,tls,60221,6248,20,2165,18,8413,38,normal,-
3012070005066215221,10.0.2.15,185.199.110.154,443,tcp,tls,221,4834,10,1406,11,6240,21,normal,-
-66123426770855176,10.0.2.15,91.198.174.208,443,tcp,tls,120540,110143,114,8339,78,118482,192,normal,-
3768688942430149917,10.0.2.15,185.199.110.154,443,tcp,tls,183,4919,12,1460,12,6379,24,normal,-
7926035745118821609,10.0.2.15,142.251.37.99,443,tcp,tls,444,6069,16,2056,16,8125,32,normal,-
5666636088115018101,10.0.2.15,87.240.132.72,443,tcp,tls,156017,11350,23,2406,22,13756,45,normal,-
-1869150187617585501,10.0.2.15,34.120.202.204,443,tcp,tls,855,6055,12,1514,13,7569,25,normal,-
1208706671171892297,10.0.2.15,142.251.36.74,443,tcp,tls,197,2204,13,2202,13,4406,26,normal,-
-2965010732304561601,10.0.2.15,142.251.36.78,443,tcp,tls,159,8155,13,1514,13,9669,26,normal,-
5576465042287142399,10.0.2.15,157.240.251.9,443,tcp,tls,198,4375,11,1352,10,5727,21,normal,-
-81501286740289060,10.0.2.15,65.9.95.6,443,tcp,tls,52969,9076,21,2623,21,11699,42,normal,-
4219370164547977406,10.0.2.15,64.4.250.37,443,tcp,tls,30411,5416,16,2201,15,7617,31,normal,-
-2156649226234361421,10.0.2.15,65.9.95.127,443,tcp,tls,156430,8716,22,2399,22,11115,44,normal,-
-7742767770939339245,10.0.2.15,44.214.60.45,443,tcp,tls,647,5763,11,2202,13,7965,24,normal,-
1045244768660027095,10.0.2.15,67.220.240.113,443,tcp,tls,6144,6870,12,1396,13,8266,25,normal,-
8241756304831971867,10.0.2.15,162.247.243.29,443,tcp,tls,840,5893,15,4424,15,10317,30,normal,-
5988026123130166270,10.0.2.15,2.16.2.186,443,tcp,tls,20307,5708,17,1691,15,7399,32,normal,-
-2676286300442618354,10.0.2.15,35.190.43.134,443,tcp,tls,734,5533,16,2192,16,7725,32,normal,-
-5831412560667484997,10.0.2.15,193.189.143.34,443,tcp,tls,19438,23732,27,2227,20,25959,47,normal,-
-4470329596223731060,10.0.2.15,52.46.132.119,443,tcp,tls,20130,7303,14,2581,14,9884,28,normal,-
-6660051745023188141,10.0.2.15,31.30.189.145,443,tcp,tls,162,1096,10,1412,10,2508,20,normal,-
4935507664497063006,10.0.2.15,157.240.30.27,443,tcp,tls,169,4491,13,1460,12,5951,25,normal,-
2316879847040069888,10.0.2.15,142.251.36.99,443,tcp,tls,566,5600,11,1406,11,7006,22,normal,-
1282532885020530665,10.0.2.15,151.101.193.51,443,tcp,tls,23699,7492,19,3014,19,10506,38,normal,-
4192978655830981029,10.0.2.15,13.107.42.14,443,tcp,tls,264,5794,14,1622,13,7416,27,normal,-
-2825168274246216536,10.0.2.15,216.239.34.36,443,tcp,tls,170340,6404,18,1915,18,8319,36,normal,-
-5217265631903349032,10.0.2.15,44.235.246.155,443,tcp,tls,60421,5963,18,1892,18,7855,36,normal,-
6956578428112439063,10.0.2.15,188.65.124.92,443,tcp,tls,30677,4464,14,1930,14,6394,28,normal,-
-2594022837712307246,10.0.2.15,142.251.36.130,443,tcp,tls,227,5870,12,1460,12,7330,24,normal,-
-6105680072858806095,10.0.2.15,8.8.8.8,53,udp,dns,52,112,1,96,1,208,2,normal,-
-2104517622539186546,10.0.2.15,179.60.195.12,443,udp,-,144,5560,8,1828,5,7388,13,normal,-
1724429038706252152,10.0.2.15,8.8.8.8,53,udp,dns,63,370,1,103,1,473,2,normal,-
-2919185197537397218,10.0.2.15,8.8.8.8,53,udp,dns,55,148,1,92,1,240,2,normal,-
-7522884062282210838,10.0.2.15,8.8.8.8,53,udp,dns,68,138,1,90,1,228,2,normal,-
431366242317447290,10.0.2.15,8.8.8.8,53,udp,dns,74,127,1,99,1,226,2,normal,-
-411655085572794906,10.0.2.15,216.239.36.54,443,udp,-,230,14164,13,1986,7,16150,20,normal,-
-6584620891309666751,10.0.2.15,8.8.8.8,53,udp,dns,60,175,1,82,1,257,2,normal,-
-8780837036653055838,10.0.2.15,8.8.8.8,53,udp,dns,64,133,1,93,1,226,2,normal,-
885745416123868858,10.0.2.15,8.8.8.8,53,udp,dns,98,133,1,117,1,250,2,normal,-
4043783178630228611,10.0.2.15,8.8.8.8,53,udp,dns,44,174,1,97,1,271,2,normal,-
-5465423331300150404,10.0.2.15,142.251.36.132,443,udp,-,973,3567,15,3080,8,6647,23,normal,-
4328318643405854365,10.0.2.15,8.8.8.8,53,udp,dns,65,149,1,84,1,233,2,normal,-
-3254276749865163658,10.0.2.15,8.8.8.8,53,udp,dns,155,407,1,102,1,509,2,normal,-
-2143829455212562064,10.0.2.15,8.8.8.8,53,udp,dns,52,124,1,108,1,232,2,normal,-
6061026258269206037,10.0.2.15,8.8.8.8,53,udp,dns,99,156,1,95,1,251,2,normal,-
709833933959611412,10.0.2.15,8.8.8.8,53,udp,dns,67,160,1,90,1,250,2,normal,-
-8664917119304604364,10.0.2.15,8.8.8.8,53,udp,dns,48,183,1,85,1,268,2,normal,-
-3741994577943970711,10.0.2.15,8.8.8.8,53,udp,dns,49,115,1,99,1,214,2,normal,-
-2786432910924845591,10.0.2.15,142.251.36.67,80,tcp,http,115248,1655,16,1364,17,3019,33,normal,-
9069502756998544071,10.0.2.15,8.8.8.8,53,udp,dns,64,168,1,87,1,255,2,normal,-
3391678042409844691,10.0.2.15,8.8.8.8,53,udp,dns,77,117,1,89,1,206,2,normal,-
3751303187930093743,10.0.2.15,8.8.8.8,53,udp,dns,57,113,1,81,1,194,2,normal,-
6893596072162592913,10.0.2.15,104.17.131.110,443,tcp,-,1089,60,1,128,2,188,3,normal,-
-3965390174127914639,10.0.2.15,8.8.8.8,53,udp,dns,75,156,1,95,1,251,2,normal,-
3741606220543588553,10.0.2.15,8.8.8.8,53,udp,dns,58,142,1,86,1,228,2,normal,-
4036566269611040281,10.0.2.15,8.8.8.8,53,udp,dns,47,217,1,86,1,303,2,normal,-
6470401313319848412,10.0.2.15,8.8.8.8,53,udp,dns,43,91,1,75,1,166,2,normal,-
1205171255725582015,10.0.2.15,35.244.142.80,443,udp,-,217,6782,6,1900,6,8682,12,normal,-
-6448715637567074601,10.0.2.15,8.8.8.8,53,udp,dns,44,174,1,90,1,264,2,normal,-
5719070143967920717,10.0.2.15,8.8.8.8,53,udp,dns,281,138,1,90,1,228,2,normal,-
7187950473267385524,10.0.2.15,8.8.8.8,53,udp,dns,241,324,1,100,1,424,2,normal,-
7789402298548935818,10.0.2.15,8.8.8.8,53,udp,dns,58,148,1,92,1,240,2,normal,-
6911967832274530588,10.0.2.15,142.251.36.78,443,udp,-,184,9643,10,2064,8,11707,18,normal,-
2121280999361169890,10.0.2.15,8.8.8.8,53,udp,dns,46,192,1,108,1,300,2,normal,-
4119161055295790397,10.0.2.15,8.8.8.8,53,udp,dns,56,207,1,114,1,321,2,normal,-
2947339193970316312,10.0.2.15,8.8.8.8,53,udp,dns,62,97,1,81,1,178,2,normal,-
-2938131749348757947,10.0.2.15,8.8.8.8,53,udp,dns,45,101,1,85,1,186,2,normal,-
2225827049396983094,10.0.2.15,8.8.8.8,53,udp,dns,83,268,1,100,1,368,2,normal,-
6317193753825452586,10.0.2.15,142.251.36.67,80,tcp,http,116748,1655,16,1364,17,3019,33,normal,-
-1496931556970246017,10.0.2.15,8.8.8.8,53,udp,dns,61,148,1,92,1,240,2,normal,-
1163604831228940398,10.0.2.15,8.8.8.8,53,udp,dns,54,152,1,96,1,248,2,normal,-
-3796401525864646467,10.0.2.15,8.8.8.8,53,udp,dns,39,157,1,80,1,237,2,normal,-
9191866885553056079,10.0.2.15,8.8.8.8,53,udp,dns,49,166,1,90,1,256,2,normal,-
8106153224105765826,10.0.2.15,8.8.8.8,53,udp,dns,44,165,1,84,1,249,2,normal,-
-7494807835231390466,10.0.2.15,8.8.8.8,53,udp,dns,45,170,1,88,1,258,2,normal,-
-164355860747109443,10.0.2.15,8.8.8.8,53,udp,dns,52,206,1,95,1,301,2,normal,-
-5129152470381760943,10.0.2.15,8.8.8.8,53,udp,dns,109,123,1,95,1,218,2,normal,-
-3985485861825002066,10.0.2.15,8.8.8.8,53,udp,dns,43,140,1,84,1,224,2,normal,-
-2021635622595014496,10.0.2.15,157.240.251.60,443,udp,-,485,8638,13,2443,10,11081,23,normal,-
5508762160561822814,10.0.2.15,8.8.8.8,53,udp,dns,181,325,1,98,1,423,2,normal,-
5526786553096602908,10.0.2.15,142.251.36.130,443,udp,-,701,8713,15,3647,13,12360,28,normal,-
8393117436879673356,10.0.2.15,8.8.8.8,53,udp,dns,108,108,1,92,1,200,2,normal,-
-6506539944507438701,10.0.2.15,8.8.8.8,53,udp,dns,41,102,1,86,1,188,2,normal,-
-7315285715487006364,10.0.2.15,8.8.8.8,53,udp,dns,5093,86,1,172,2,258,3,normal,-
-7773847866108009859,10.0.2.15,8.8.8.8,53,udp,dns,88,115,1,99,1,214,2,normal,-
-3625906985144933442,10.0.2.15,216.239.32.36,443,udp,-,29162,10560,48,11067,37,21627,85,normal,-
874552845003228088,10.0.2.15,8.8.8.8,53,udp,dns,63,245,1,115,1,360,2,normal,-
-885516507921876983,10.0.2.15,8.8.8.8,53,udp,dns,64,218,1,95,1,313,2,normal,-
2094593680194277236,10.0.2.15,157.240.30.35,443,udp,-,96,5420,9,2061,7,7481,16,normal,-
-6531957909329712668,10.0.2.15,8.8.8.8,53,udp,dns,49,267,1,87,1,354,2,normal,-
4851399644207283505,10.0.2.15,8.8.8.8,53,udp,dns,82,118,1,90,1,208,2,normal,-
-7692790576783879722,10.0.2.15,8.8.8.8,53,udp,dns,33,114,1,86,1,200,2,normal,-
5990312191093111902,10.0.2.15,8.8.8.8,53,udp,dns,60,351,1,85,1,436,2,normal,-
-6197075704645900204,10.0.2.15,8.8.8.8,53,udp,dns,58,162,1,82,1,244,2,normal,-
-1415371295324560325,10.0.2.15,8.8.8.8,53,udp,dns,61,210,1,79,1,289,2,normal,-
6830611412446799498,10.0.2.15,8.8.8.8,53,udp,dns,61,96,1,80,1,176,2,normal,-
-7562743412427698504,10.0.2.15,8.8.8.8,53,udp,dns,90,112,1,84,1,196,2,normal,-
3307430466273046244,10.0.2.15,8.8.8.8,53,udp,dns,50,143,1,90,1,233,2,normal,-
8403629936927067023,10.0.2.15,8.8.8.8,53,udp,dns,39,116,1,84,1,200,2,normal,-
-5674432779174995468,10.0.2.15,8.8.8.8,53,udp,dns,51,307,1,101,1,408,2,normal,-
-4751148065197196709,10.0.2.15,8.8.8.8,53,udp,dns,48,125,1,90,1,215,2,normal,-
957177851163492122,10.0.2.15,8.8.8.8,53,udp,dns,49,129,1,81,1,210,2,normal,-
4308195417800817510,10.0.2.15,8.8.8.8,53,udp,dns,127,130,1,82,1,212,2,normal,-
-2994803810535374466,10.0.2.15,8.8.8.8,53,udp,dns,51,96,1,80,1,176,2,normal,-
-3326937682611505180,10.0.2.15,8.8.8.8,53,udp,dns,70,189,1,85,1,274,2,normal,-
6314049706591454001,10.0.2.15,8.8.8.8,53,udp,dns,66,145,1,89,1,234,2,normal,-
9112881736637822745,10.0.2.15,8.8.8.8,53,udp,dns,74,163,1,92,1,255,2,normal,-
2829670263593733441,10.0.2.15,8.8.8.8,53,udp,dns,54,210,1,91,1,301,2,normal,-
6886670150008913711,10.0.2.15,8.8.8.8,53,udp,dns,147,143,1,86,1,229,2,normal,-
2920124334184740543,10.0.2.15,8.8.8.8,53,udp,dns,156,115,1,87,1,202,2,normal,-
4064881551237321499,10.0.2.15,8.8.8.8,53,udp,dns,44,112,1,80,1,192,2,normal,-
8553113109912285561,10.0.2.15,142.251.37.99,443,tcp,-,43,60,1,128,2,188,3,normal,-
8420332296665249125,10.0.2.15,8.8.8.8,53,udp,dns,55,250,1,86,1,336,2,normal,-
7180343190053492105,10.0.2.15,95.100.146.66,80,tcp,http,36660,1362,8,929,9,2291,17,normal,-
3130343157409943490,10.0.2.15,104.19.154.83,443,udp,-,258,7814,14,2506,7,10320,21,normal,-
2395733563898651978,10.0.2.15,8.8.8.8,53,udp,dns,65,110,1,78,1,188,2,normal,-
5806873354634388496,10.0.2.15,142.251.37.104,443,udp,-,2189,159986,123,4775,40,164761,163,normal,-
-3063062515112447910,10.0.2.15,8.8.8.8,53,udp,dns,75,164,1,100,1,264,2,normal,-
2641844865145480439,10.0.2.15,216.239.34.36,443,udp,-,10058,8260,17,3550,15,11810,32,normal,-
3653366150137783441,10.0.2.15,95.100.146.41,80,tcp,http,190301,10042,35,5771,36,15813,71,normal,-
3443011424421925420,10.0.2.15,8.8.8.8,53,udp,dns,435,279,1,87,1,366,2,normal,-
-9169029646291300765,10.0.2.15,8.8.8.8,53,udp,dns,51,312,1,88,1,400,2,normal,-
9182240863055601638,10.0.2.15,8.8.8.8,53,udp,dns,49,117,1,101,1,218,2,normal,-
-615312077166518177,10.0.2.15,8.8.8.8,53,udp,dns,45,146,1,93,1,239,2,normal,-
1172103168580771029,10.0.2.15,216.239.34.36,443,udp,-,216,7433,9,2359,10,9792,19,normal,-
-5084467600132285000,10.0.2.15,8.8.8.8,53,udp,dns,55,202,1,86,1,288,2,normal,-
6449574259258508894,10.0.2.15,31.30.189.145,443,tcp,tls,503,4056,11,1460,12,5516,23,normal,-
-423006401739641616,10.0.2.15,34.120.15.67,443,udp,-,11321,7009,16,6054,18,13063,34,normal,-
4511610787781440057,10.0.2.15,8.8.8.8,53,udp,dns,52,173,1,92,1,265,2,normal,-
-6309624038989685868,10.0.2.15,8.8.8.8,53,udp,dns,51,282,1,85,1,367,2,normal,-
-1759268227298073434,10.0.2.15,8.8.8.8,53,udp,dns,73,115,1,99,1,214,2,normal,-
3414490674026152382,10.0.2.15,8.8.8.8,53,udp,dns,51,224,1,94,1,318,2,normal,-
8159051362905500224,10.0.2.15,142.251.36.78,443,udp,-,387,11210,13,2783,14,13993,27,normal,-
2466388704478335199,10.0.2.15,8.8.8.8,53,udp,dns,69,154,1,90,1,244,2,normal,-
-8227907791408128177,10.0.2.15,8.8.8.8,53,udp,dns,65,162,1,103,1,265,2,normal,-
-6576223366518930568,10.0.2.15,8.8.8.8,53,udp,dns,55,141,1,85,1,226,2,normal,-
-8137645068178175520,10.0.2.15,13.107.21.200,443,tcp,-,90,60,1,128,2,188,3,normal,-
1998916870806657882,10.0.2.15,8.8.8.8,53,udp,dns,128,149,1,92,1,241,2,normal,-
7966306868044300273,10.0.2.15,31.30.189.145,443,udp,-,4595,1520334,1280,44226,271,1564560,1551,normal,-
-4783830820973829411,10.0.2.15,8.8.8.8,53,udp,dns,59,144,1,87,1,231,2,normal,-
3062048338175115586,10.0.2.15,8.8.8.8,53,udp,dns,134,138,1,83,1,221,2,normal,-
-3401441577639575600,10.0.2.15,8.8.8.8,53,udp,dns,61,163,1,105,1,268,2,normal,-
4106573987216245122,10.0.2.15,8.8.8.8,53,udp,dns,54,185,1,84,1,269,2,normal,-
7711130470409821889,10.0.2.15,8.8.8.8,53,udp,dns,80091,341,2,191,2,532,4,normal,-
2998080006148319177,10.0.2.15,8.8.8.8,53,udp,dns,39,116,1,84,1,200,2,normal,-
184000721676038366,10.0.2.15,8.8.8.8,53,udp,dns,67,192,1,80,1,272,2,normal,-
56585541050761362,10.0.2.15,8.8.8.8,53,udp,dns,42,169,1,88,1,257,2,normal,-
4209645346362311417,10.0.2.15,8.8.8.8,53,udp,dns,42,148,1,92,1,240,2,normal,-
5159009230722056854,10.0.2.15,8.8.8.8,53,udp,dns,82,268,1,100,1,368,2,normal,-
-3697258416206678059,10.0.2.15,142.251.36.78,443,udp,-,283,9728,11,2359,10,12087,21,normal,-
-2081038646626545553,10.0.2.15,8.8.8.8,53,udp,dns,67,96,1,80,1,176,2,normal,-
6915803055816241487,10.0.2.15,8.8.8.8,53,udp,dns,69,232,1,95,1,327,2,normal,-
8007781704056447759,10.0.2.15,142.250.27.156,443,udp,-,1895,2848,8,2127,5,4975,13,normal,-
-948307316507893494,10.0.2.15,8.8.8.8,53,udp,dns,57,113,1,97,1,210,2,normal,-
-3232001189920387596,10.0.2.15,8.8.8.8,53,udp,dns,100,145,1,117,1,262,2,normal,-
-8307068188617339413,10.0.2.15,8.8.8.8,53,udp,dns,58,178,1,97,1,275,2,normal,-
-1272644373045543568,10.0.2.15,8.8.8.8,53,udp,dns,70,165,1,84,1,249,2,normal,-
3988824862908819847,10.0.2.15,8.8.8.8,53,udp,dns,79,102,1,86,1,188,2,normal,-
-5022857407317816342,10.0.2.15,8.8.8.8,53,udp,dns,72,95,1,79,1,174,2,normal,-
1266797108719385928,10.0.2.15,8.8.8.8,53,udp,dns,43,164,1,100,1,264,2,normal,-
1021083377719415461,10.0.2.15,8.8.8.8,53,udp,dns,54,151,1,87,1,238,2,normal,-
-6858443566330443188,10.0.2.15,142.251.36.67,80,tcp,http,115739,1656,16,1365,17,3021,33,normal,-
458545834540099417,10.0.2.15,8.8.8.8,53,udp,dns,74,99,1,83,1,182,2,normal,-
-3692057490511108648,10.0.2.15,142.250.27.155,443,udp,-,178,2290,4,1628,3,3918,7,normal,-
5962237132255239098,10.0.2.15,8.8.8.8,53,udp,dns,66,119,1,91,1,210,2,normal,-
7171576911393638361,10.0.2.15,194.228.230.20,443,udp,-,4549,7721,13,2566,9,10287,22,normal,-
2077871799246377298,10.0.2.15,8.8.8.8,53,udp,dns,56,159,1,81,1,240,2,normal,-
-4975906422991789762,10.0.2.15,8.8.8.8,53,udp,dns,71,174,1,90,1,264,2,normal,-
4415671096636309964,10.0.2.15,8.8.8.8,53,udp,dns,178,178,1,97,1,275,2,normal,-
-8467258673345828082,10.0.2.15,8.8.8.8,53,udp,dns,298,282,1,125,1,407,2,normal,-
-514970157852120006,10.0.2.15,8.8.8.8,53,udp,dns,61,153,1,89,1,242,2,normal,-
-6629179318507545710,10.0.2.15,8.8.8.8,53,udp,dns,92,117,1,101,1,218,2,normal,-
-8725102594684654599,10.0.2.15,8.8.8.8,53,udp,dns,55,117,1,85,1,202,2,normal,-
6493538240529869077,10.0.2.15,8.8.8.8,53,udp,dns,67,100,1,84,1,184,2,normal,-
-9203963219204672851,10.0.2.15,8.8.8.8,53,udp,dns,68,230,1,90,1,320,2,normal,-
5441666347193231165,10.0.2.15,8.8.8.8,53,udp,dns,186,116,1,88,1,204,2,normal,-
-9111205339350936665,10.0.2.15,8.8.8.8,53,udp,dns,73,156,1,95,1,251,2,normal,-
6235094778151734585,10.0.2.15,8.8.8.8,53,udp,dns,67,108,1,80,1,188,2,normal,-
-5911417382482189943,10.0.2.15,8.8.8.8,53,udp,dns,59,136,1,89,1,225,2,normal,-
8147522532703924043,10.0.2.15,8.8.8.8,53,udp,dns,70,176,1,115,1,291,2,normal,-
2763802947931860050,10.0.2.15,8.8.8.8,53,udp,dns,60,323,1,88,1,411,2,normal,-
-8070815099971146253,10.0.2.15,142.251.36.78,443,udp,-,336,9734,11,2447,11,12181,22,normal,-
1223142883634512253,10.0.2.15,8.8.8.8,53,udp,dns,55,148,1,92,1,240,2,normal,-
-3259216049705963365,10.0.2.15,8.8.8.8,53,udp,dns,95,127,1,99,1,226,2,normal,-
6923574761070027504,10.0.2.15,8.8.8.8,53,udp,dns,131,149,1,93,1,242,2,normal,-
6798458421033371590,10.0.2.15,8.8.8.8,53,udp,dns,94,124,1,96,1,220,2,normal,-
7319697600503580166,10.0.2.15,8.8.8.8,53,udp,dns,186,182,1,124,1,306,2,normal,-
8205022544050575169,10.0.2.15,8.8.8.8,53,udp,dns,61,119,1,91,1,210,2,normal,-
-4153563169367697149,10.0.2.15,8.8.8.8,53,udp,dns,56,206,1,91,1,297,2,normal,-
995167960529608699,10.0.2.15,8.8.8.8,53,udp,dns,53,98,1,82,1,180,2,normal,-
-1096325036026275636,10.0.2.15,8.8.8.8,53,udp,dns,61,123,1,95,1,218,2,normal,-
3005115618975510007,10.0.2.15,8.8.8.8,53,udp,dns,74,108,1,92,1,200,2,normal,-
6436867347556200126,10.0.2.15,8.8.8.8,53,udp,dns,97,150,1,86,1,236,2,normal,-
-7572373313799615101,10.0.2.15,8.8.8.8,53,udp,dns,66,127,1,95,1,222,2,normal,-
-7672130279507311238,10.0.2.15,8.8.8.8,53,udp,dns,108420,298,2,170,2,468,4,normal,-
4458542056866623359,10.0.2.15,8.8.8.8,53,udp,dns,148,112,1,80,1,192,2,normal,-
-344669571080634967,10.0.2.15,8.8.8.8,53,udp,dns,64,134,1,78,1,212,2,normal,-
9193614730368239908,10.0.2.15,8.8.8.8,53,udp,dns,35,117,1,101,1,218,2,normal,-
-451642277594571866,10.0.2.15,8.8.8.8,53,udp,dns,64,207,1,114,1,321,2,normal,-
5622242807059903830,10.0.2.15,8.8.8.8,53,udp,dns,107,207,1,114,1,321,2,normal,-
7962387565014586717,10.0.2.15,142.251.36.132,443,udp,-,175,2290,4,1629,3,3919,7,normal,-
4343448239220492846,10.0.2.15,8.8.8.8,53,udp,dns,42,210,1,79,1,289,2,normal,-
4892981728883260377,10.0.2.15,8.8.8.8,53,udp,dns,44,148,1,92,1,240,2,normal,-
5705658235596361718,10.0.2.15,8.8.8.8,53,udp,dns,53,141,1,82,1,223,2,normal,-
-7759081025789532997,10.0.2.15,142.251.36.72,443,udp,-,446,174990,132,5434,48,180424,180,normal,-
6180907540034457190,10.0.2.15,142.251.36.110,443,udp,-,594,9821,12,2530,12,12351,24,normal,-
-137739618693631136,10.0.2.15,8.8.8.8,53,udp,dns,435,205,1,87,1,292,2,normal,-
-5710615576805899125,10.0.2.15,142.251.36.150,443,udp,-,182,7452,8,2067,8,9519,16,normal,-
1509102729741459706,10.0.2.15,8.8.8.8,53,udp,dns,117,146,1,81,1,227,2,normal,-
-8155832980481436257,10.0.2.15,8.8.8.8,53,udp,dns,83,191,1,95,1,286,2,normal,-
-575009604603096383,10.0.2.15,8.8.8.8,53,udp,dns,59,181,1,79,1,260,2,normal,-
-1903503426272806126,10.0.2.15,8.8.8.8,53,udp,dns,54,169,1,89,1,258,2,normal,-
-5599019634946510040,10.0.2.15,8.8.8.8,53,udp,dns,49,124,1,89,1,213,2,normal,-
674822258635555003,10.0.2.15,8.8.8.8,53,udp,dns,60,100,1,84,1,184,2,normal,-
2214925356764845302,10.0.2.15,8.8.8.8,53,udp,dns,92,129,1,84,1,213,2,normal,-
-1003066611474238700,10.0.2.15,8.8.8.8,53,udp,dns,74,111,1,83,1,194,2,normal,-
3317689615615777686,10.0.2.15,8.8.8.8,53,udp,dns,62,148,1,92,1,240,2,normal,-
-577047645662017112,10.0.2.15,8.8.8.8,53,udp,dns,64,174,1,93,1,267,2,normal,-
-8339102353206546167,10.0.2.15,8.8.8.8,53,udp,dns,122,232,1,92,1,324,2,normal,-
-4056198760788148633,10.0.2.15,8.8.8.8,53,udp,dns,55,226,1,89,1,315,2,normal,-
-7857876618268970053,10.0.2.15,8.8.8.8,53,udp,dns,49,152,1,101,1,253,2,normal,-
5379900659064599173,10.0.2.15,8.8.8.8,53,udp,dns,87,190,1,84,1,274,2,normal,-
-2915813614532731408,10.0.2.15,8.8.8.8,53,udp,dns,104,143,1,87,1,230,2,normal,-
6057210151919587561,10.0.2.15,8.8.8.8,53,udp,dns,49,307,1,101,1,408,2,normal,-
3171302082301305787,10.0.2.15,8.8.8.8,53,udp,dns,72,100,1,84,1,184,2,normal,-
-7457807168996531301,10.0.2.15,8.8.8.8,53,udp,dns,59,212,1,86,1,298,2,normal,-
2419312445313659203,10.0.2.15,8.8.8.8,53,udp,dns,43,143,1,75,1,218,2,normal,-
-6357675445156417897,10.0.2.15,8.8.8.8,53,udp,dns,64,148,1,92,1,240,2,normal,-
-3971409328975576826,10.0.2.15,92.88.3.20,443,udp,-,152,5252,8,1909,6,7161,14,normal,-
-5992617671208035554,10.0.2.15,8.8.8.8,53,udp,dns,51,135,1,87,1,222,2,normal,-
-6264890363497829007,10.0.2.15,8.8.8.8,53,udp,dns,53,114,1,86,1,200,2,normal,-
-6682632722863693647,10.0.2.15,8.8.8.8,53,udp,dns,44,207,1,114,1,321,2,normal,-
6943250483166324522,10.0.2.15,52.94.236.248,80,tcp,http,31815,765,7,818,8,1583,15,normal,-
-4300164646972935271,10.0.2.15,8.8.8.8,53,udp,dns,101,163,1,102,1,265,2,normal,-
-6239474490195713121,10.0.2.15,8.8.8.8,53,udp,dns,77,130,1,91,1,221,2,normal,-
3218399944903509997,10.0.2.15,8.8.8.8,53,udp,dns,67,207,1,114,1,321,2,normal,-
-7270936848926175756,10.0.2.15,142.251.37.110,443,udp,-,391,9736,11,2278,9,12014,20,normal,-
-5788604851708263113,10.0.2.15,8.8.8.8,53,udp,dns,53,137,1,107,1,244,2,normal,-
281902201927118511,10.0.2.15,8.8.8.8,53,udp,dns,54,116,1,88,1,204,2,normal,-
-1767712213380350045,10.0.2.15,104.18.32.68,80,tcp,http,63178,1464,11,1100,12,2564,23,normal,-
3267637013929199603,10.0.2.15,8.8.8.8,53,udp,dns,77,110,1,82,1,192,2,normal,-
5650105089819957979,10.0.2.15,8.8.8.8,53,udp,dns,66,97,1,81,1,178,2,normal,-
-7280098791868972053,10.0.2.15,8.8.8.8,53,udp,dns,59,108,1,92,1,200,2,normal,-
-8897081249595220286,10.0.2.15,8.8.8.8,53,udp,dns,132,178,1,97,1,275,2,normal,-
8350110634769278061,10.0.2.15,8.8.8.8,53,udp,dns,48,216,1,88,1,304,2,normal,-
-5096971108950532763,10.0.2.15,8.8.8.8,53,udp,dns,53,208,1,85,1,293,2,normal,-
-3851861645694663218,10.0.2.15,8.8.8.8,53,udp,dns,46,176,1,98,1,274,2,normal,-
-6943850796347152080,10.0.2.15,8.8.8.8,53,udp,dns,73,148,1,92,1,240,2,normal,-
-3324284467470368499,10.0.2.15,8.8.8.8,53,udp,dns,53,196,1,91,1,287,2,normal,-
-3343993390205966606,10.0.2.15,8.8.8.8,53,udp,dns,46,157,1,103,1,260,2,normal,-
-8557065320962356804,10.0.2.15,8.8.8.8,53,udp,dns,52,150,1,89,1,239,2,normal,-
5552093258265931083,10.0.2.15,8.8.8.8,53,udp,dns,58,140,1,84,1,224,2,normal,-
-788152099342328467,10.0.2.15,8.8.8.8,53,udp,dns,73,187,1,100,1,287,2,normal,-
3943742904263807102,10.0.2.15,34.120.202.204,443,udp,-,2698,11089,74,49614,79,60703,153,normal,-
1130922075452307696,10.0.2.15,8.8.8.8,53,udp,dns,58,102,1,86,1,188,2,normal,-
-684995499178010044,10.0.2.15,8.8.8.8,53,udp,dns,89,350,1,83,1,433,2,normal,-
1637400881069509527,10.0.2.15,8.8.8.8,53,udp,dns,105466,278,2,169,2,447,4,normal,-
-6682187553217936783,10.0.2.15,142.251.37.110,443,udp,-,321,7326,8,1980,7,9306,15,normal,-
3552282830007772108,10.0.2.15,8.8.8.8,53,udp,dns,279,137,1,81,1,218,2,normal,-
6804045143848649677,10.0.2.15,8.8.8.8,53,udp,dns,51,112,1,96,1,208,2,normal,-
855520510186048168,10.0.2.15,157.240.30.35,443,udp,-,106,2294,7,1679,4,3973,11,normal,-
2210524296808524792,10.0.2.15,8.8.8.8,53,udp,dns,53,180,1,99,1,279,2,normal,-
-8346900336957974375,10.0.2.15,8.8.8.8,53,udp,dns,65,198,1,86,1,284,2,normal,-
-7520043595511667892,10.0.2.15,142.251.36.130,443,udp,-,4938,2435,6,2380,6,4815,12,normal,-
-4914490140741565367,10.0.2.15,8.8.8.8,53,udp,dns,69,208,1,95,1,303,2,normal,-
6776507156682308502,10.0.2.15,8.8.8.8,53,udp,dns,64,167,1,86,1,253,2,normal,-
855673040640612156,10.0.2.15,8.8.8.8,53,udp,dns,63,282,1,84,1,366,2,normal,-
5919125025929306776,10.0.2.15,8.8.8.8,53,udp,dns,51,152,1,96,1,248,2,normal,-
6211670914431082669,10.0.2.15,8.8.8.8,53,udp,dns,51,161,1,97,1,258,2,normal,-
-4112596102507187272,10.0.2.15,31.30.189.145,443,udp,-,1762,449143,408,35506,156,484649,564,normal,-
-5766391761131263397,10.0.2.15,8.8.8.8,53,udp,dns,68,143,1,86,1,229,2,normal,-
245584635992864833,10.0.2.15,8.8.8.8,53,udp,dns,63,166,1,96,1,262,2,normal,-
6738067476883829535,10.0.2.15,8.8.8.8,53,udp,dns,310,206,1,83,1,289,2,normal,-
-2272946625865320822,10.0.2.15,192.229.221.25,443,tcp,-,2132,60,1,128,2,188,3,normal,-
8169473797054987131,10.0.2.15,8.8.8.8,53,udp,dns,55,146,1,81,1,227,2,normal,-
-4941794450185347440,10.0.2.15,142.251.36.67,443,udp,-,265,77651,59,3203,19,80854,78,normal,-
-2079613929192127130,10.0.2.15,8.8.8.8,53,udp,dns,68,289,1,88,1,377,2,normal,-
4745300800871039069,10.0.2.15,8.8.8.8,53,udp,dns,48,307,1,101,1,408,2,normal,-
-1254714683813590776,10.0.2.15,8.8.8.8,53,udp,dns,58,234,1,84,1,318,2,normal,-
2978343881607868366,10.0.2.15,8.8.8.8,53,udp,dns,67,119,1,87,1,206,2,normal,-
-3235578241694545226,10.0.2.15,8.8.8.8,53,udp,dns,80,196,1,93,1,289,2,normal,-
-6236434510093087120,10.0.2.15,8.8.8.8,53,udp,dns,59,111,1,95,1,206,2,normal,-
9056533971044919200,10.0.2.15,8.8.8.8,53,udp,dns,46,197,1,86,1,283,2,normal,-
-3454445411563361147,10.0.2.15,8.8.8.8,53,udp,dns,68,131,1,86,1,217,2,normal,-
-3652166326889913775,10.0.2.15,8.8.8.8,53,udp,dns,311,158,1,87,1,245,2,normal,-
5160649534803742180,10.0.2.15,142.251.36.67,80,tcp,http,182920,10027,39,6914,40,16941,79,normal,-
7745682466965825680,10.0.2.15,8.8.8.8,53,udp,dns,44,138,1,90,1,228,2,normal,-
4250690359366756660,10.0.2.15,8.8.8.8,53,udp,dns,49,207,1,114,1,321,2,normal,-
-1482952356451641471,10.0.2.15,8.8.8.8,53,udp,dns,61,111,1,95,1,206,2,normal,-
-7191779667157734824,10.0.2.15,8.8.8.8,53,udp,dns,76,164,1,100,1,264,2,normal,-
8195751037622347620,10.0.2.15,8.8.8.8,53,udp,dns,47,170,1,89,1,259,2,normal,-
8570913965360327720,10.0.2.15,157.240.221.16,443,udp,-,175,5564,8,1911,6,7475,14,normal,-
5845822286370441485,10.0.2.15,142.251.36.99,443,udp,-,8692,3961,16,3272,9,7233,25,normal,-
1513944806195566473,10.0.2.15,8.8.8.8,53,udp,dns,37,116,1,84,1,200,2,normal,-
-106966923316999356,10.0.2.15,104.17.50.95,443,udp,-,2153,42119,58,43301,55,85420,113,normal,-
3290475924043149485,10.0.2.15,8.8.8.8,53,udp,dns,179,181,1,117,1,298,2,normal,-
-7835362003748733145,10.0.2.15,8.8.8.8,53,udp,dns,44,148,1,84,1,232,2,normal,-
-9182703906866813513,10.0.2.15,31.30.189.145,443,udp,-,154,5327,9,2291,9,7618,18,normal,-
5365951679021508545,10.0.2.15,8.8.8.8,53,udp,dns,56,111,1,83,1,194,2,normal,-
2235477695271907143,10.0.2.15,192.229.221.25,443,tcp,-,1220,60,1,128,2,188,3,normal,-
-4283108939378473845,10.0.2.15,8.8.8.8,53,udp,dns,48,161,1,103,1,264,2,normal,-
-5944064870695899003,10.0.2.15,8.8.8.8,53,udp,dns,79,186,1,99,1,285,2,normal,-
-3640791291364327937,10.0.2.15,8.8.8.8,53,udp,dns,60,119,1,91,1,210,2,normal,-
-6460626576551244500,10.0.2.15,8.8.8.8,53,udp,dns,51,190,1,105,1,295,2,normal,-
-2733779139315053091,10.0.2.15,65.9.9.138,80,tcp,http,26460,1362,7,885,8,2247,15,normal,-
-1069372002466636495,10.0.2.15,8.8.8.8,53,udp,dns,73,179,1,98,1,277,2,normal,-
2754913017861000796,10.0.2.15,8.8.8.8,53,udp,dns,90,137,1,81,1,218,2,normal,-
4155802916823757049,10.0.2.15,8.8.8.8,53,udp,dns,53,144,1,88,1,232,2,normal,-
-8998213882589216873,10.0.2.15,8.8.8.8,53,udp,dns,33,152,1,86,1,238,2,normal,-
-670929523957337682,10.0.2.15,142.251.37.110,443,udp,-,12705,10615,26,5473,17,16088,43,normal,-
-6729384686434656669,10.0.2.15,8.8.8.8,53,udp,dns,54,140,1,84,1,224,2,normal,-
4721063451820312955,10.0.2.15,8.8.8.8,53,udp,dns,52,208,1,85,1,293,2,normal,-
877206060144364769,10.0.2.15,8.8.8.8,53,udp,dns,53,207,1,114,1,321,2,normal,-
-5972908748472437447,10.0.2.15,8.8.8.8,53,udp,dns,55,145,1,96,1,241,2,normal,-
-6058631547924208226,10.0.2.15,142.251.36.78,443,udp,-,257,2435,6,2086,6,4521,12,normal,-
6064863968056352727,10.0.2.15,8.8.8.8,53,udp,dns,128,149,1,92,1,241,2,normal,-
2619811850619997928,10.0.2.15,8.8.8.8,53,udp,dns,87,209,1,84,1,293,2,normal,-
5916909886118694499,10.0.2.15,8.8.8.8,53,udp,dns,83,193,1,92,1,285,2,normal,-
-2021252550580231401,10.0.2.15,8.8.8.8,53,udp,dns,178,121,1,89,1,210,2,normal,-
-1082913127654716637,10.0.2.15,8.8.8.8,53,udp,dns,49,114,1,98,1,212,2,normal,-
-5749774978514430147,10.0.2.15,8.8.8.8,53,udp,dns,56,230,1,87,1,317,2,normal,-
-4797985269786411859,10.0.2.15,8.8.8.8,53,udp,dns,52,184,1,85,1,269,2,normal,-
4132283935636560064,10.0.2.15,8.8.8.8,53,udp,dns,92,156,1,101,1,257,2,normal,-
-8625648321133143222,10.0.2.15,8.8.8.8,53,udp,dns,48,131,1,85,1,216,2,normal,-
9171868934786668640,10.0.2.15,8.8.8.8,53,udp,dns,48,170,1,90,1,260,2,normal,-
3226588624170926792,10.0.2.15,90.182.114.17,443,udp,-,159,5260,8,1825,5,7085,13,normal,-
-6387690398359307977,10.0.2.15,8.8.8.8,53,udp,dns,50,174,1,92,1,266,2,normal,-
2063922819203286670,10.0.2.15,8.8.8.8,53,udp,dns,90,141,1,82,1,223,2,normal,-
-7138760909698246612,10.0.2.15,8.8.8.8,53,udp,dns,89,152,1,95,1,247,2,normal,-
-1324234857603239194,10.0.2.15,104.17.50.95,443,udp,-,26138,10583,22,5900,20,16483,42,normal,-
-5338660441488504889,10.0.2.15,157.240.30.35,443,udp,-,27743,9784,19,10512,17,20296,36,normal,-
4793042207573259503,10.0.2.15,8.8.8.8,53,udp,dns,520,163,1,99,1,262,2,normal,-
-7227142839880356911,10.0.2.15,8.8.8.8,53,udp,dns,1065,200,1,90,1,290,2,normal,-
-1019106679910899314,10.0.2.15,142.251.37.109,443,udp,-,335,10751,14,2648,10,13399,24,normal,-
-1545778432600581624,10.0.2.15,8.8.8.8,53,udp,dns,208,163,1,102,1,265,2,normal,-
1967143364230440188,10.0.2.15,8.8.8.8,53,udp,dns,50,117,1,85,1,202,2,normal,-
-5084791895725997974,10.0.2.15,8.8.8.8,53,udp,dns,90,103,1,87,1,190,2,normal,-
-8597594865732798632,10.0.2.15,8.8.8.8,53,udp,dns,63,129,1,101,1,230,2,normal,-
2235133823388134285,10.0.2.15,8.8.8.8,53,udp,dns,42,207,1,114,1,321,2,normal,-
6588687509298805316,10.0.2.15,8.8.8.8,53,udp,dns,130,164,1,98,1,262,2,normal,-
2017409910207784494,10.0.2.15,8.8.8.8,53,udp,dns,52,131,1,99,1,230,2,normal,-
1351863477250178501,10.0.2.15,8.8.8.8,53,udp,dns,61,180,1,95,1,275,2,normal,-
3107205383105092007,10.0.2.15,8.8.8.8,53,udp,dns,312,158,1,87,1,245,2,normal,-
7336004719758998545,10.0.2.15,8.8.8.8,53,udp,dns,102,120,1,88,1,208,2,normal,-
-4965499227159933122,10.0.2.15,8.8.8.8,53,udp,dns,52,114,1,98,1,212,2,normal,-
-1761730561102324236,10.0.2.15,8.8.8.8,53,udp,dns,53,152,1,96,1,248,2,normal,-
8574397818693980510,10.0.2.15,8.8.8.8,53,udp,dns,75,135,1,88,1,223,2,normal,-
5213366656391858985,10.0.2.15,95.100.146.66,80,tcp,http,105358,3727,18,2315,19,6042,37,normal,-
-3432232320986361431,10.0.2.15,8.8.8.8,53,udp,dns,127,158,1,82,1,240,2,normal,-
8804885049058463352,10.0.2.15,8.8.8.8,53,udp,dns,54,115,1,99,1,214,2,normal,-
7539355192748589941,10.0.2.15,8.8.8.8,53,udp,dns,180,207,1,114,1,321,2,normal,-
-4541489304608253134,10.0.2.15,34.107.204.85,443,udp,-,961,4197,3,3169,4,7366,7,normal,-
64826879934194668,10.0.2.15,8.8.8.8,53,udp,dns,101,203,1,125,1,328,2,normal,-
5872350290707867972,10.0.2.15,8.8.8.8,53,udp,dns,45,100,1,84,1,184,2,normal,-
6017202755284974697,10.0.2.15,8.8.8.8,53,udp,dns,44,162,1,82,1,244,2,normal,-
1923298257808680634,10.0.2.15,8.8.8.8,53,udp,dns,48,133,1,88,1,221,2,normal,-
2479076937922445141,10.0.2.15,8.8.8.8,53,udp,dns,90,99,1,83,1,182,2,normal,-
7461084532822423580,10.0.2.15,8.8.8.8,53,udp,dns,63,148,1,84,1,232,2,normal,-
1462169469978499184,10.0.2.15,8.8.8.8,53,udp,dns,62,186,1,87,1,273,2,normal,-
7676654943450086596,10.0.2.15,8.8.8.8,53,udp,dns,50,214,1,85,1,299,2,normal,-
-8112926265802512281,10.0.2.15,35.190.43.134,443,udp,-,8153,6574,15,3351,12,9925,27,normal,-
-7312457252051891781,10.0.2.15,8.8.8.8,53,udp,dns,48,162,1,82,1,244,2,normal,-
-1838497477876177338,10.0.2.15,8.8.8.8,53,udp,dns,81,164,1,100,1,264,2,normal,-
-8063364128658489403,10.0.2.15,8.8.8.8,53,udp,dns,48,233,1,101,1,334,2,normal,-
5399641046353226459,10.0.2.15,142.251.36.132,443,udp,-,243,3452,9,2583,10,6035,19,normal,-
8344057785171519094,10.0.2.15,8.8.8.8,53,udp,dns,61,102,1,86,1,188,2,normal,-
653337121066972795,10.0.2.15,8.8.8.8,53,udp,dns,57,134,1,81,1,215,2,normal,-
-4264615899977347233,10.0.2.15,8.8.8.8,53,udp,dns,54,113,1,81,1,194,2,normal,-
-6971601559591311910,10.0.2.15,8.8.8.8,53,udp,dns,38,98,1,82,1,180,2,normal,-
4763999309041657501,10.0.2.15,8.8.8.8,53,udp,dns,74,117,1,87,1,204,2,normal,-
1412742687828871267,10.0.2.15,8.8.8.8,53,udp,dns,48,138,1,93,1,231,2,normal,-
1511586808677849118,10.0.2.15,142.251.37.106,443,udp,-,184,7367,8,1982,7,9349,15,normal,-
7095704671384554510,10.0.2.15,151.101.192.81,443,udp,-,174,5412,5,2052,6,7464,11,normal,-
-6944712163612396683,10.0.2.15,8.8.8.8,53,udp,dns,76,134,1,78,1,212,2,normal,-
-2674394471060596856,10.0.2.15,8.8.8.8,53,udp,dns,48,129,1,101,1,230,2,normal,-
7165236837992085058,10.0.2.15,8.8.8.8,53,udp,dns,66,189,1,90,1,279,2,normal,-
-3350850736068518320,10.0.2.15,8.8.8.8,53,udp,dns,48,112,1,96,1,208,2,normal,-
-3777052771139319309,10.0.2.15,142.251.36.142,443,udp,-,563,11888,16,2681,11,14569,27,normal,-
5916585590524981525,10.0.2.15,8.8.8.8,53,udp,dns,71,109,1,93,1,202,2,normal,-
4883433808796490259,10.0.2.15,8.8.8.8,53,udp,dns,147,143,1,86,1,229,2,normal,-
-5084348773308063846,10.0.2.15,8.8.8.8,53,udp,dns,48,152,1,88,1,240,2,normal,-
-6731474551406619530,10.0.2.15,8.8.8.8,53,udp,dns,68,138,1,90,1,228,2,normal,-
-4629645303907929304,10.0.2.15,8.8.8.8,53,udp,dns,45,141,1,84,1,225,2,normal,-
-6105561246034584941,10.0.2.15,8.8.8.8,53,udp,dns,81,143,1,86,1,229,2,normal,-
-5904524769056714587,10.0.2.15,8.8.8.8,53,udp,dns,39,146,1,81,1,227,2,normal,-
3976378058344839089,10.0.2.15,157.240.251.9,443,udp,-,12358,3550826,2984,79674,541,3630500,3525,normal,-
-9071879182002518472,10.0.2.15,8.8.8.8,53,udp,dns,90,138,1,83,1,221,2,normal,-
-179161871647161458,10.0.2.15,142.251.36.132,443,udp,-,6894,3998,14,3575,13,7573,27,normal,-
-589846230409073805,10.0.2.15,8.8.8.8,53,udp,dns,48,178,1,97,1,275,2,normal,-
-2819034159559884926,10.0.2.15,8.8.8.8,53,udp,dns,65,133,1,93,1,226,2,normal,-
1699287487542520754,10.0.2.15,8.8.8.8,53,udp,dns,43,141,1,82,1,223,2,normal,-
-6127583455274698778,10.0.2.15,8.8.8.8,53,udp,dns,57,100,1,84,1,184,2,normal,-
-1307394222143663349,10.0.2.15,8.8.8.8,53,udp,dns,53,137,1,84,1,221,2,normal,-
3116753303191862125,10.0.2.15,8.8.8.8,53,udp,dns,55,120,1,88,1,208,2,normal,-
1887447986869855404,10.0.2.15,8.8.8.8,53,udp,dns,50,106,1,90,1,196,2,normal,-
7619568297008643869,10.0.2.15,142.251.36.110,443,udp,-,252,9635,10,2068,8,11703,18,normal,-
-6006566651251126182,10.0.2.15,8.8.8.8,53,udp,dns,52,149,1,92,1,241,2,normal,-
4023899007600652602,10.0.2.15,8.8.8.8,53,udp,dns,96,100,1,84,1,184,2,normal,-
7000263804492951365,10.0.2.15,157.240.30.27,443,udp,-,138,5418,9,2091,7,7509,16,normal,-
7093338276169980914,10.0.2.15,8.8.8.8,53,udp,dns,36,103,1,75,1,178,2,normal,-
-7387870396280377209,10.0.2.15,8.8.8.8,53,udp,dns,55,149,1,93,1,242,2,normal,-
4056760440105127885,10.0.2.15,8.8.8.8,53,udp,dns,488,210,1,132,1,342,2,normal,-
-2724692021852688329,10.0.2.15,142.251.36.132,443,udp,-,8448,7173,33,4538,29,11711,62,normal,-
-3744062839478405358,10.0.2.15,8.8.8.8,53,udp,dns,56,191,1,85,1,276,2,normal,-
1411237776463610440,10.0.2.15,8.8.8.8,53,udp,dns,207,133,1,78,1,211,2,normal,-
829930780224625215,10.0.2.15,8.8.8.8,53,udp,dns,53,207,1,114,1,321,2,normal,-
6526366240596342388,10.0.2.15,142.251.36.132,443,udp,-,2315,728831,609,61106,250,789937,859,normal,-
5046190930734156883,10.0.2.15,8.8.8.8,53,udp,dns,69,153,1,93,1,246,2,normal,-
2798412225251519162,10.0.2.15,8.8.8.8,53,udp,dns,57,179,1,98,1,277,2,normal,-
6908621414359976799,10.0.2.15,8.8.8.8,53,udp,dns,55,129,1,101,1,230,2,normal,-
8561180989099613342,10.0.2.15,8.8.8.8,53,udp,dns,94,187,1,92,1,279,2,normal,-
-2803731406971426624,10.0.2.15,8.8.8.8,53,udp,dns,68,131,1,99,1,230,2,normal,-
4906570736006510924,10.0.2.15,8.8.8.8,53,udp,dns,295,184,1,99,1,283,2,normal,-
-5906739908867326864,10.0.2.15,8.8.8.8,53,udp,dns,68,141,1,84,1,225,2,normal,-
-8666416920479045896,10.0.2.15,8.8.8.8,53,udp,dns,145,118,1,90,1,208,2,normal,-
4391756874966349256,10.0.2.15,8.8.8.8,53,udp,dns,62,129,1,101,1,230,2,normal,-
3015597898547389756,10.0.2.15,8.8.8.8,53,udp,dns,66,136,1,80,1,216,2,normal,-
-6013897906869719457,10.0.2.15,157.240.251.9,443,udp,-,132,5416,9,2178,8,7594,17,normal,-
3767672776553288468,10.0.2.15,8.8.8.8,53,udp,dns,56,99,1,83,1,182,2,normal,-
4218952120353462608,10.0.2.15,8.8.8.8,53,udp,dns,50,121,1,89,1,210,2,normal,-
-4307961462511415911,10.0.2.15,8.8.8.8,53,udp,dns,91,145,1,93,1,238,2,normal,-
-4721866112090133861,10.0.2.15,8.8.8.8,53,udp,dns,55,189,1,93,1,282,2,normal,-
-8207927565204806796,10.0.2.15,8.8.8.8,53,udp,dns,62,107,1,91,1,198,2,normal,-
-5435287366006787383,10.0.2.15,8.8.8.8,53,udp,dns,64,246,1,86,1,332,2,normal,-
-1240765703770500148,10.0.2.15,8.8.8.8,53,udp,dns,103,181,1,79,1,260,2,normal,-
1325927306269947297,10.0.2.15,8.8.8.8,53,udp,dns,37,178,1,97,1,275,2,normal,-
1916855214815567668,10.0.2.15,8.8.8.8,53,udp,dns,78,187,1,83,1,270,2,normal,-
-2924328797934741177,10.0.2.15,8.8.8.8,53,udp,dns,142,148,1,92,1,240,2,normal,-
2431201780860300888,10.0.2.15,8.8.8.8,53,udp,dns,72,107,1,79,1,186,2,normal,-
-8848772613849363876,10.0.2.15,8.8.8.8,53,udp,dns,87,163,1,105,1,268,2,normal,-
2404248747300661747,10.0.2.15,8.8.8.8,53,udp,dns,44,163,1,105,1,268,2,normal,-
-6608937139185958251,10.0.2.15,142.251.36.130,443,tcp,-,58,60,1,128,2,188,3,normal,-
2928959934306001130,10.0.2.15,8.8.8.8,53,udp,dns,43,169,1,87,1,256,2,normal,-
1472603867615208528,10.0.2.15,8.8.8.8,53,udp,dns,48,150,1,96,1,246,2,normal,-
-3588294376607743242,10.0.2.15,192.229.221.95,80,tcp,http,184728,4738,28,3282,29,8020,57,normal,-
-7858737985534214656,10.0.2.15,8.8.8.8,53,udp,dns,74,137,1,88,1,225,2,normal,-
670094811565363438,10.0.2.15,8.8.8.8,53,udp,dns,266,174,1,92,1,266,2,normal,-
-4810925257422775679,10.0.2.15,192.124.249.24,80,tcp,http,65053,2996,12,1084,12,4080,24,normal,-
304296588696115727,10.0.2.15,8.8.8.8,53,udp,dns,155,365,1,89,1,454,2,normal,-
-8728918701034273075,10.0.2.15,8.8.8.8,53,udp,dns,91,191,1,95,1,286,2,normal,-
-9021336222366631597,10.0.2.15,8.8.8.8,53,udp,dns,57,98,1,82,1,180,2,normal,-
-250105255918400762,10.0.2.15,8.8.8.8,53,udp,dns,60,255,1,88,1,343,2,normal,-
-8483742041705834237,10.0.2.15,8.8.8.8,53,udp,dns,55,107,1,91,1,198,2,normal,-
7624879607233019307,10.0.2.15,8.8.8.8,53,udp,dns,59,178,1,97,1,275,2,normal,-
-3232715678909454569,10.0.2.15,8.8.8.8,53,udp,dns,172,163,1,99,1,262,2,normal,-
5396247694054693508,10.0.2.15,34.107.204.85,443,udp,-,400,2572,6,2539,6,5111,12,normal,-
6173130069268039035,10.0.2.15,8.8.8.8,53,udp,dns,71,148,1,92,1,240,2,normal,-
2736121961363803401,10.0.2.15,8.8.8.8,53,udp,dns,52,110,1,82,1,192,2,normal,-
-8236594344229653692,10.0.2.15,8.8.8.8,53,udp,dns,44,116,1,84,1,200,2,normal,-
-5093331251705502063,10.0.2.15,8.8.8.8,53,udp,dns,169,184,1,99,1,283,2,normal,-
-5606640201380402904,10.0.2.15,8.8.8.8,53,udp,dns,66,172,1,91,1,263,2,normal,-
-3245767614361173487,10.0.2.15,8.8.8.8,53,udp,dns,37,99,1,83,1,182,2,normal,-
-7809034789726044170,10.0.2.15,8.8.8.8,53,udp,dns,53,218,1,95,1,313,2,normal,-
-2861827017379513998,10.0.2.15,8.8.8.8,53,udp,dns,62,160,1,99,1,259,2,normal,-
4280657430634476335,10.0.2.15,8.8.8.8,53,udp,dns,61,151,1,91,1,242,2,normal,-
5127137868755340269,10.0.2.15,8.8.8.8,53,udp,dns,60,111,1,95,1,206,2,normal,-
-6311486831754628695,10.0.2.15,8.8.8.8,53,udp,dns,45,178,1,97,1,275,2,normal,-
6133589967628854619,10.0.2.15,8.8.8.8,53,udp,dns,64,163,1,99,1,262,2,normal,-
3029400849961406526,10.0.2.15,8.8.8.8,53,udp,dns,96,190,1,92,1,282,2,normal,-
7550003534676065508,10.0.2.15,8.8.8.8,53,udp,dns,56,124,1,92,1,216,2,normal,-
-4846621629559845922,10.0.2.15,8.8.8.8,53,udp,dns,46,112,1,80,1,192,2,normal,-
-1661113396342331064,10.0.2.15,8.8.8.8,53,udp,dns,58,108,1,80,1,188,2,normal,-
1293893141680740543,10.0.2.15,8.8.8.8,53,udp,dns,48,216,1,96,1,312,2,normal,-
-4322115911323998359,10.0.2.15,8.8.8.8,53,udp,dns,64,206,1,95,1,301,2,normal,-
-8579602707133069494,10.0.2.15,8.8.8.8,53,udp,dns,63,117,1,101,1,218,2,normal,-
3101618660289813920,10.0.2.15,8.8.8.8,53,udp,dns,175,180,1,93,1,273,2,normal,-
3286982945074296415,10.0.2.15,8.8.8.8,53,udp,dns,65,148,1,92,1,240,2,normal,-
6614397457719120258,10.0.2.15,8.8.8.8,53,udp,dns,90,132,1,100,1,232,2,normal,-
-7983831553920394788,10.0.2.15,8.8.8.8,53,udp,dns,47,116,1,84,1,200,2,normal,-
-71171397209843903,10.0.2.15,34.120.202.204,443,udp,-,645,8348,10,2541,12,10889,22,normal,-
2686117241612395723,10.0.2.15,8.8.8.8,53,udp,dns,85,146,1,81,1,227,2,normal,-
-3570317446976642216,10.0.2.15,8.8.8.8,53,udp,dns,40,169,1,88,1,257,2,normal,-
3606222944050511423,10.0.2.15,216.239.36.54,443,udp,-,518,17387,18,3187,12,20574,30,normal,-
7793755476570085923,10.0.2.15,8.8.8.8,53,udp,dns,51,141,1,84,1,225,2,normal,-
-3496590846408511839,10.0.2.15,8.8.8.8,53,udp,dns,138,118,1,86,1,204,2,normal,-
7741866360616207204,10.0.2.15,8.8.8.8,53,udp,dns,56,184,1,87,1,271,2,normal,-
1082716092264428211,10.0.2.15,151.101.193.16,443,tcp,-,385,60,1,128,2,188,3,normal,-
2278245929714066607,10.0.2.15,8.8.8.8,53,udp,dns,56,193,1,88,1,281,2,normal,-
-5487613556480580632,10.0.2.15,8.8.8.8,53,udp,dns,112,207,1,114,1,321,2,normal,-
4688847991039108701,10.0.2.15,8.8.8.8,53,udp,dns,90,210,1,84,1,294,2,normal,-
7448205754144524483,10.0.2.15,8.8.8.8,53,udp,dns,311,207,1,114,1,321,2,normal,-
-2093562909235217758,10.0.2.15,8.8.8.8,53,udp,dns,76,123,1,88,1,211,2,normal,-
-590493653383552185,10.0.2.15,8.8.8.8,53,udp,dns,63,191,1,85,1,276,2,normal,-
4179826321583716940,10.0.2.15,8.8.8.8,53,udp,dns,52,148,1,92,1,240,2,normal,-
5581522089649171561,10.0.2.15,8.8.8.8,53,udp,dns,57,274,1,84,1,358,2,normal,-
1917716582080812271,10.0.2.15,8.8.8.8,53,udp,dns,49,141,1,82,1,223,2,normal,-
-8553249214612738328,10.0.2.15,8.8.8.8,53,udp,dns,100,203,1,125,1,328,2,normal,-
-4830604387982320647,10.0.2.15,8.8.8.8,53,udp,dns,60,116,1,84,1,200,2,normal,-
-2738401162981084862,10.0.2.15,8.8.8.8,53,udp,dns,155252,264,2,187,2,451,4,normal,-
8945185314859356414,10.0.2.15,8.8.8.8,53,udp,dns,48,163,1,105,1,268,2,normal,-
5540505446662526590,10.0.2.15,8.8.8.8,53,udp,dns,86,143,1,75,1,218,2,normal,-
-6747315543879557029,10.0.2.15,8.8.8.8,53,udp,dns,77,149,1,92,1,241,2,normal,-
-5682968193176627830,10.0.2.15,8.8.8.8,53,udp,dns,176,233,1,101,1,334,2,normal,-
5583913478564371614,10.0.2.15,8.8.8.8,53,udp,dns,40,211,1,83,1,294,2,normal,-
9194984900095183262,10.0.2.15,192.229.221.95,80,tcp,http,143316,4560,24,3066,25,7626,49,normal,-
4095940568824472220,10.0.2.15,8.8.8.8,53,udp,dns,67,157,1,93,1,250,2,normal,-
7315020126888717087,10.0.2.15,8.8.8.8,53,udp,dns,65,155,1,94,1,249,2,normal,-
3766042590349378225,10.0.2.15,8.8.8.8,53,udp,dns,65,133,1,77,1,210,2,normal,-
1798934354377952549,10.0.2.15,104.18.32.68,80,tcp,http,94924,2056,14,1260,15,3316,29,normal,-
-2519455148193725195,10.0.2.15,95.100.146.66,80,tcp,-,5273,180,3,236,4,416,7,normal,-
-6630533091052913384,10.0.2.15,8.8.8.8,53,udp,dns,88,113,1,97,1,210,2,normal,-
-1290468899578670634,10.0.2.15,8.8.8.8,53,udp,dns,45,113,1,85,1,198,2,normal,-
8139692300060233407,10.0.2.15,8.8.8.8,53,udp,dns,43,164,1,84,1,248,2,normal,-
882349660541708728,10.0.2.15,8.8.8.8,53,udp,dns,207,94,1,78,1,172,2,normal,-
498297452846795251,10.0.2.15,8.8.8.8,53,udp,dns,56,177,1,93,1,270,2,normal,-
4861688013214918991,10.0.2.15,8.8.8.8,53,udp,dns,42,107,1,91,1,198,2,normal,-
5364123640275482312,10.0.2.15,8.8.8.8,53,udp,dns,42,169,1,91,1,260,2,normal,-
-2172136261317568879,10.0.2.15,8.8.8.8,53,udp,dns,72,163,1,98,1,261,2,normal,-
-5741653867382236533,10.0.2.15,8.8.8.8,53,udp,dns,44,178,1,97,1,275,2,normal,-
-679879950232622561,10.0.2.15,8.8.8.8,53,udp,dns,77,142,1,91,1,233,2,normal,-
8515267621143419141,10.0.2.15,8.8.8.8,53,udp,dns,108,164,1,100,1,264,2,normal,-
-3783278645523876800,10.0.2.15,8.8.8.8,53,udp,dns,42,138,1,90,1,228,2,normal,-
15421701222094965,10.0.2.15,8.8.8.8,53,udp,dns,45,141,1,85,1,226,2,normal,-
5717869376773909385,10.0.2.15,95.100.146.66,80,tcp,-,5274,180,3,236,4,416,7,normal,-
3183113024133858587,10.0.2.15,8.8.8.8,53,udp,dns,152,166,1,92,1,258,2,normal,-
-3543688709010716049,10.0.2.15,8.8.8.8,53,udp,dns,135,150,1,89,1,239,2,normal,-
-5831397709527892185,10.0.2.15,8.8.8.8,53,udp,dns,53,143,1,87,1,230,2,normal,-
-1128502984356431113,10.0.2.15,142.251.36.132,443,udp,-,1835,1062657,843,58706,235,1121363,1078,normal,-
470759465680454076,10.0.2.15,8.8.8.8,53,udp,dns,48,100,1,84,1,184,2,normal,-
-8671237393495624449,10.0.2.15,8.8.8.8,53,udp,dns,46,233,1,101,1,334,2,normal,-
4663712975432849346,10.0.2.15,157.240.30.27,443,udp,-,232,5653,9,1828,5,7481,14,normal,-
154718768568975518,10.0.2.15,8.8.8.8,53,udp,dns,83,121,1,105,1,226,2,normal,-
-5761270736799005411,10.0.2.15,192.124.249.24,80,tcp,http,37043,2841,9,976,10,3817,19,normal,-
-208475289307253485,10.0.2.15,8.8.8.8,53,udp,dns,70,213,1,85,1,298,2,normal,-
7439754358142779283,10.0.2.15,142.251.36.78,443,udp,-,241,4602,10,3800,6,8402,16,normal,-
-3094772384107941690,10.0.2.15,8.8.8.8,53,udp,dns,47,171,1,84,1,255,2,normal,-
-753578499348796462,10.0.2.15,8.8.8.8,53,udp,dns,74,114,1,98,1,212,2,normal,-
7509163990441112085,10.0.2.15,8.8.8.8,53,udp,dns,51,112,1,84,1,196,2,normal,-
-7668828473178748609,10.0.2.15,8.8.8.8,53,udp,dns,88,146,1,81,1,227,2,normal,-
-6917616130651042068,10.0.2.15,8.8.8.8,53,udp,dns,42,175,1,79,1,254,2,normal,-
3874583013699449021,10.0.2.15,8.8.8.8,53,udp,dns,46,188,1,100,1,288,2,normal,-
2345261549151815852,10.0.2.15,8.8.8.8,53,udp,dns,62,95,1,79,1,174,2,normal,-
8397762229866209020,10.0.2.15,142.251.36.99,443,udp,-,173,3209,8,3286,6,6495,14,normal,-
2971126972588680036,10.0.2.15,8.8.8.8,53,udp,dns,47,123,1,86,1,209,2,normal,-
5899983395340754216,10.0.2.15,8.8.8.8,53,udp,dns,73,132,1,87,1,219,2,normal,-
-5357206419204559333,10.0.2.15,8.8.8.8,53,udp,dns,385,161,1,100,1,261,2,normal,-
-4466112055723270205,10.0.2.15,8.8.8.8,53,udp,dns,130,178,1,98,1,276,2,normal,-
7694004606974124311,10.0.2.15,65.9.9.138,80,tcp,http,155236,6389,26,3643,27,10032,53,normal,-
-8343970034236952356,10.0.2.15,142.251.36.137,443,udp,-,326,7022,8,1902,6,8924,14,normal,-
513179854667795207,10.0.2.15,8.8.8.8,53,udp,dns,50,141,1,85,1,226,2,normal,-
-4250144074848749195,10.0.2.15,216.239.34.36,443,udp,-,968,4923,5,2676,4,7599,9,normal,-
6909159654244455996,10.0.2.15,8.8.8.8,53,udp,dns,56,136,1,79,1,215,2,normal,-
-2405375703164195627,10.0.2.15,8.8.8.8,53,udp,dns,47,150,1,89,1,239,2,normal,-
-8490896481357246221,10.0.2.15,8.8.8.8,53,udp,dns,50,116,1,84,1,200,2,normal,-
-7606800035516969476,10.0.2.15,8.8.8.8,53,udp,dns,56,177,1,85,1,262,2,normal,-
2761087263422947023,10.0.2.15,8.8.8.8,53,udp,dns,63,123,1,95,1,218,2,normal,-
3241331403344038842,10.0.2.15,8.8.8.8,53,udp,dns,55,186,1,86,1,272,2,normal,-
-1184467911632925089,10.0.2.15,8.8.8.8,53,udp,dns,87,148,1,92,1,240,2,normal,-
7749520176752972370,10.0.2.15,8.8.8.8,53,udp,dns,134,112,1,84,1,196,2,normal,-
-5132871353344686479,10.0.2.15,8.8.8.8,53,udp,dns,76,126,1,98,1,224,2,normal,-
-1067043082919212788,10.0.2.15,8.8.8.8,53,udp,dns,90,144,1,88,1,232,2,normal,-
-4530533050513196959,10.0.2.15,8.8.8.8,53,udp,dns,40,232,1,86,1,318,2,normal,-
-3904990754457098181,10.0.2.15,8.8.8.8,53,udp,dns,69,207,1,114,1,321,2,normal,-
-1151496127825503055,10.0.2.15,8.8.8.8,53,udp,dns,55,145,1,88,1,233,2,normal,-
-231725996254085580,10.0.2.15,8.8.8.8,53,udp,dns,38,96,1,80,1,176,2,normal,-
5430314083318121109,10.0.2.15,8.8.8.8,53,udp,dns,135,121,1,89,1,210,2,normal,-
-8429108021578138447,10.0.2.15,8.8.8.8,53,udp,dns,56,178,1,88,1,266,2,normal,-
-174225984907434454,10.0.2.15,8.8.8.8,53,udp,dns,181,275,1,98,1,373,2,normal,-
-246481190328460404,10.0.2.15,142.251.36.70,443,udp,-,6125,7365,10,2600,10,9965,20,normal,-
5215934163479429586,10.0.2.15,142.251.37.98,443,udp,-,403,9182,14,2953,13,12135,27,normal,-
4250236304968955480,10.0.2.15,157.240.30.35,443,udp,-,134,2293,7,1678,4,3971,11,normal,-
4570716812754507106,10.0.2.15,8.8.8.8,53,udp,dns,41,177,1,84,1,261,2,normal,-
-4600264354459859231,10.0.2.15,8.8.8.8,53,udp,dns,263,179,1,86,1,265,2,normal,-
-6995069269405999129,10.0.2.15,52.94.236.248,80,tcp,-,5692,180,3,236,4,416,7,normal,-
840719693930561451,10.0.2.15,8.8.8.8,53,udp,dns,70,190,1,83,1,273,2,normal,-
2949944527176282588,10.0.2.15,8.8.8.8,53,udp,dns,58,133,1,86,1,219,2,normal,-
-4240054255332908145,10.0.2.15,8.8.8.8,53,udp,dns,49,104,1,88,1,192,2,normal,-
-1978153729580423218,10.0.2.15,142.251.37.99,443,udp,-,758,15687,14,4777,9,20464,23,normal,-
-902647299256361518,10.0.2.15,8.8.8.8,53,udp,dns,57,183,1,85,1,268,2,normal,-
8372132844009391898,10.0.2.15,8.8.8.8,53,udp,dns,73,165,1,100,1,265,2,normal,-
8782609489113687290,10.0.2.15,8.8.8.8,53,udp,dns,70,206,1,94,1,300,2,normal,-
3382456509436945628,10.0.2.15,8.8.8.8,53,udp,dns,48,189,1,87,1,276,2,normal,-
6373575144624779093,10.0.2.15,8.8.8.8,53,udp,dns,65,272,1,106,1,378,2,normal,-
-7576656715144662025,10.0.2.15,8.8.8.8,53,udp,dns,95,157,1,93,1,250,2,normal,-
3413953602354620753,10.0.2.15,8.8.8.8,53,udp,dns,121,214,1,133,1,347,2,normal,-
-6604664914262254856,10.0.2.15,192.229.221.95,80,tcp,http,139009,4222,23,3012,24,7234,47,normal,-
-1375476677616149017,10.0.2.15,8.8.8.8,53,udp,dns,36,178,1,97,1,275,2,normal,-
1460664558613238357,10.0.2.15,8.8.8.8,53,udp,dns,63,171,1,84,1,255,2,normal,-
2704729068841218171,10.0.2.15,52.94.236.248,80,tcp,-,5951,180,3,236,4,416,7,normal,-
-3239861643039592150,10.0.2.15,8.8.8.8,53,udp,dns,70,201,1,84,1,285,2,normal,-
4062229978452685498,10.0.2.15,142.251.36.67,80,tcp,http,188335,14947,51,10098,51,25045,102,normal,-
-3606388938916490010,10.0.2.15,65.9.9.138,80,tcp,http,48509,5531,15,3049,16,8580,31,normal,-
3357554012848675076,10.0.2.15,8.8.8.8,53,udp,dns,152,108,1,92,1,200,2,normal,-
9018493670580176316,10.0.2.15,8.8.8.8,53,udp,dns,52,218,1,95,1,313,2,normal,-
-322456480503635251,10.0.2.15,8.8.8.8,53,udp,dns,48,142,1,81,1,223,2,normal,-
-3842074671032432254,10.0.2.15,8.8.8.8,53,udp,dns,82,149,1,92,1,241,2,normal,-
-4973154211509645856,10.0.2.15,8.8.8.8,53,udp,dns,49,114,1,86,1,200,2,normal,-
-7528995502373283995,10.0.2.15,8.8.8.8,53,udp,dns,95,112,1,96,1,208,2,normal,-
1106961140060124151,10.0.2.15,8.8.8.8,53,udp,dns,69,148,1,92,1,240,2,normal,-
8831013242326088769,10.0.2.15,8.8.8.8,53,udp,dns,50,150,1,86,1,236,2,normal,-
-6409712607599421814,10.0.2.15,8.8.8.8,53,udp,dns,52,148,1,92,1,240,2,normal,-
8479367376749265425,10.0.2.15,8.8.8.8,53,udp,dns,66,132,1,87,1,219,2,normal,-
-8594610335579003939,10.0.2.15,65.9.9.138,80,tcp,http,25664,1362,7,885,8,2247,15,normal,-
7329675456502697009,10.0.2.15,8.8.8.8,53,udp,dns,63,258,1,84,1,342,2,normal,-
-3614725903567575590,10.0.2.15,8.8.8.8,53,udp,dns,53,130,1,114,1,244,2,normal,-
-6118085508643257146,10.0.2.15,8.8.8.8,53,udp,dns,80,126,1,98,1,224,2,normal,-
-696845261282119253,10.0.2.15,142.251.36.131,443,udp,-,192,7663,7,1982,7,9645,14,normal,-
-5794072747699320046,10.0.2.15,8.8.8.8,53,udp,dns,79,114,1,86,1,200,2,normal,-
-2027695593573344367,10.0.2.15,8.8.8.8,53,udp,dns,83,215,1,95,1,310,2,normal,-
7257457646174289615,10.0.2.15,8.8.8.8,53,udp,dns,88879,256,2,175,2,431,4,normal,-
-6324851707838121061,10.0.2.15,8.8.8.8,53,udp,dns,65,206,1,94,1,300,2,normal,-
5363560290106308492,10.0.2.15,8.8.8.8,53,udp,dns,42,160,1,99,1,259,2,normal,-
-4017520026414208820,10.0.2.15,8.8.8.8,53,udp,dns,56,158,1,97,1,255,2,normal,-
9117819868265674884,10.0.2.15,8.8.8.8,53,udp,dns,146,106,1,90,1,196,2,normal,-
6462928793375080746,10.0.2.15,8.8.8.8,53,udp,dns,61,146,1,82,1,228,2,normal,-
7521070987447410257,10.0.2.15,8.8.8.8,53,udp,dns,194,199,1,92,1,291,2,normal,-
-2555158992060827656,10.0.2.15,8.8.8.8,53,udp,dns,35,158,1,94,1,252,2,normal,-
-9047524837774210624,10.0.2.15,142.251.37.110,443,udp,-,198,9635,10,2148,9,11783,19,normal,-
-3169648456664895489,10.0.2.15,8.8.8.8,53,udp,dns,87,208,1,84,1,292,2,normal,-
-3725830458090267806,10.0.2.15,8.8.8.8,53,udp,dns,66,132,1,84,1,216,2,normal,-
-4691610012791624854,10.0.2.15,8.8.8.8,53,udp,dns,101,191,1,82,1,273,2,normal,-
-6852539237365362531,10.0.2.15,8.8.8.8,53,udp,dns,426,178,1,97,1,275,2,normal,-
5213953250314264239,10.0.2.15,8.8.8.8,53,udp,dns,53,158,1,94,1,252,2,normal,-
7892898686917214767,10.0.2.15,142.251.36.99,443,udp,-,1398,55949,49,4338,26,60287,75,normal,-
576913152869682038,10.0.2.15,192.229.221.25,443,tcp,-,2131,60,1,128,2,188,3,normal,-
-327861907126915838,10.0.2.15,8.8.8.8,53,udp,dns,431,381,2,184,2,565,4,normal,-
9050527835169383070,10.0.2.15,8.8.8.8,53,udp,dns,58,107,1,91,1,198,2,normal,-
-3181172753393213143,10.0.2.15,142.251.37.110,443,udp,-,218,7441,9,2363,10,9804,19,normal,-
7552542970080390759,10.0.2.15,8.8.8.8,53,udp,dns,139452,236,2,188,2,424,4,normal,-
-2181980106980251699,10.0.2.15,8.8.8.8,53,udp,dns,119,218,1,142,1,360,2,normal,-
2405878933504571990,10.0.2.15,8.8.8.8,53,udp,dns,61,165,1,84,1,249,2,normal,-
-437213506643604930,10.0.2.15,8.8.8.8,53,udp,dns,65,114,1,86,1,200,2,normal,-
-8730486417870406972,10.0.2.15,8.8.8.8,53,udp,dns,74,97,1,81,1,178,2,normal,-
479417648484179319,10.0.2.15,8.8.8.8,53,udp,dns,101,157,1,101,1,258,2,normal,-
2299553649965113471,10.0.2.15,8.8.8.8,53,udp,dns,118,179,1,98,1,277,2,normal,-
-7495456426418816414,10.0.2.15,8.8.8.8,53,udp,dns,113,177,1,84,1,261,2,normal,-
844234276336942735,10.0.2.15,8.8.8.8,53,udp,dns,48,203,1,91,1,294,2,normal,-
-5360459175385003989,10.0.2.15,8.8.8.8,53,udp,dns,98,153,1,92,1,245,2,normal,-
-1717312418640239091,10.0.2.15,31.13.84.4,443,udp,-,119,5561,8,1826,5,7387,13,normal,-
3496813742079461457,10.0.2.15,142.251.36.130,443,udp,-,684,3068,8,2157,6,5225,14,normal,-
-4490712446743452697,10.0.2.15,151.101.0.81,443,udp,-,390,7878,9,2517,10,10395,19,normal,-
-3914687721843603371,10.0.2.15,8.8.8.8,53,udp,dns,85,178,1,88,1,266,2,normal,-
914502826138430817,10.0.2.15,142.250.27.154,443,udp,-,2221,8338,19,4727,14,13065,33,normal,-
4923036379803451021,10.0.2.15,8.8.8.8,53,udp,dns,42,169,1,88,1,257,2,normal,-
-6948012801728011744,10.0.2.15,8.8.8.8,53,udp,dns,159,149,1,84,1,233,2,normal,-
3396822811020136218,10.0.2.15,8.8.8.8,53,udp,dns,47,177,1,84,1,261,2,normal,-
-3095984325464541458,10.0.2.15,8.8.8.8,53,udp,dns,55,114,1,98,1,212,2,normal,-
6793238568683056954,10.0.2.15,8.8.8.8,53,udp,dns,88,158,1,101,1,259,2,normal,-
-1367710082553182295,10.0.2.15,8.8.8.8,53,udp,dns,89,152,1,88,1,240,2,normal,-
3582750445973792533,10.0.2.15,8.8.8.8,53,udp,dns,60,307,1,101,1,408,2,normal,-
5115874352745648750,10.0.2.15,8.8.8.8,53,udp,dns,64,142,1,81,1,223,2,normal,-
-595314126400130738,10.0.2.15,8.8.8.8,53,udp,dns,66,138,1,90,1,228,2,normal,-
7090085519989536258,10.0.2.15,8.8.8.8,53,udp,dns,53,102,1,86,1,188,2,normal,-
-5589936422920572143,10.0.2.15,142.251.36.99,443,udp,-,297,6987,8,1982,7,8969,15,normal,-
136924462511362370,10.0.2.15,8.8.8.8,53,udp,dns,54,146,1,81,1,227,2,normal,-
2083601521463370859,10.0.2.15,8.8.8.8,53,udp,dns,53,152,1,96,1,248,2,normal,-
3558931341770376894,10.0.2.15,8.8.8.8,53,udp,dns,86,156,1,92,1,248,2,normal,-
-3616230814932836417,10.0.2.15,8.8.8.8,53,udp,dns,73,135,1,98,1,233,2,normal,-
-1377638749436203901,10.0.2.15,142.251.36.132,443,udp,-,4950,13637,31,3845,24,17482,55,normal,-
6406399731590179701,10.0.2.15,8.8.8.8,53,udp,dns,242,156,1,87,1,243,2,normal,-
6037325980890011552,10.0.2.15,8.8.8.8,53,udp,dns,36,146,1,90,1,236,2,normal,-
-6364052590347889838,10.0.2.15,8.8.8.8,53,udp,dns,48,148,1,92,1,240,2,normal,-
-1115741912060423197,10.0.2.15,8.8.8.8,53,udp,dns,62,245,1,86,1,331,2,normal,-
-2967588950749798697,10.0.2.15,8.8.8.8,53,udp,dns,29,164,1,106,1,270,2,normal,-
3232136148868781970,10.0.2.15,8.8.8.8,53,udp,dns,80,154,1,93,1,247,2,normal,-
3836516434737063946,10.0.2.15,8.8.8.8,53,udp,dns,51,207,1,114,1,321,2,normal,-
-4073543496413399391,10.0.2.15,8.8.8.8,53,udp,dns,61,137,1,90,1,227,2,normal,-
93608729016164619,10.0.2.15,151.101.193.16,443,tcp,-,111,60,1,128,2,188,3,normal,-
-5184223397627033569,10.0.2.15,8.8.8.8,53,udp,dns,60,101,1,85,1,186,2,normal,-
-5014959858150836022,10.0.2.15,142.251.36.99,443,udp,-,2096,8868,26,4646,20,13514,46,normal,-
4400443427787874771,10.0.2.15,8.8.8.8,53,udp,dns,68,145,1,86,1,231,2,normal,-
4227638673174988123,10.0.2.15,8.8.8.8,53,udp,dns,64,120,1,88,1,208,2,normal,-
7320728245668182434,10.0.2.15,8.8.8.8,53,udp,dns,42,169,1,85,1,254,2,normal,-
1194574251303568810,10.0.2.15,8.8.8.8,53,udp,dns,44,126,1,98,1,224,2,normal,-
-5083042882697866577,10.0.2.15,8.8.8.8,53,udp,dns,99,115,1,87,1,202,2,normal,-
9171663466017176820,10.0.2.15,8.8.8.8,53,udp,dns,59,155,1,99,1,254,2,normal,-
-867006533371360592,10.0.2.15,142.251.37.99,443,udp,-,218,7016,8,1989,7,9005,15,normal,-
-4693084703681371763,10.0.2.15,8.8.8.8,53,udp,dns,64,187,1,99,1,286,2,normal,-
-1739708351862210399,10.0.2.15,8.8.8.8,53,udp,dns,46,194,1,82,1,276,2,normal,-
4882458661794434226,10.0.2.15,8.8.8.8,53,udp,dns,52,148,1,92,1,240,2,normal,-
-5409696244410693595,10.0.2.15,8.8.8.8,53,udp,dns,52,149,1,92,1,241,2,normal,-
5126925092677521614,10.0.2.15,8.8.8.8,53,udp,dns,57,127,1,99,1,226,2,normal,-
1865941245863744982,10.0.2.15,8.8.8.8,53,udp,dns,64,248,1,91,1,339,2,normal,-
-1347938690449807842,10.0.2.15,8.8.8.8,53,udp,dns,69,198,1,90,1,288,2,normal,-
8555988338554151410,10.0.2.15,8.8.8.8,53,udp,dns,44,207,1,114,1,321,2,normal,-
6969668257005271637,10.0.2.15,8.8.8.8,53,udp,dns,46,125,1,88,1,213,2,normal,-
1366877201807847471,10.0.2.15,8.8.8.8,53,udp,dns,44,192,1,108,1,300,2,normal,-
6796953509668110763,10.0.2.15,8.8.8.8,53,udp,dns,68,246,1,91,1,337,2,normal,-
5635508686802388971,10.0.2.15,8.8.8.8,53,udp,dns,47,178,1,88,1,266,2,normal,-
-4779105465423795927,10.0.2.15,8.8.8.8,53,udp,dns,49,155,1,99,1,254,2,normal,-
5887804182116219427,10.0.2.15,8.8.8.8,53,udp,dns,50,100,1,84,1,184,2,normal,-
2267664729665747326,10.0.2.15,142.251.36.132,443,udp,-,28473,13112,31,6488,26,19600,57,normal,-
2790834305138281297,10.0.2.15,34.107.221.82,80,tcp,http,190534,2436,26,2381,27,4817,53,normal,-
725998053813314317,10.0.2.15,8.8.8.8,53,udp,dns,141,138,1,90,1,228,2,normal,-
-3064091992064102610,10.0.2.15,8.8.8.8,53,udp,dns,68,155,1,99,1,254,2,normal,-
-4218893413358038911,10.0.2.15,8.8.8.8,53,udp,dns,101,215,1,82,1,297,2,normal,-
-1842478187065039502,10.0.2.15,8.8.8.8,53,udp,dns,91,113,1,81,1,194,2,normal,-
5160109652562762303,10.0.2.15,8.8.8.8,53,udp,dns,45,167,1,83,1,250,2,normal,-
-7279544409798092133,10.0.2.15,142.251.36.130,443,udp,-,179,6981,8,2071,8,9052,16,normal,-
2475302339039096968,10.0.2.15,192.229.221.95,80,tcp,http,139009,4280,23,3012,24,7292,47,normal,-
-5666240723153751105,10.0.2.15,8.8.8.8,53,udp,dns,50,145,1,89,1,234,2,normal,-
6959118445645413842,10.0.2.15,142.251.36.132,443,udp,-,47734,20651,108,10389,83,31040,191,normal,-
-7595892294986812086,10.0.2.15,8.8.8.8,53,udp,dns,49,148,1,92,1,240,2,normal,-
1153411579687849981,10.0.2.15,8.8.8.8,53,udp,dns,46,136,1,79,1,215,2,normal,-
4548646721579222864,10.0.2.15,8.8.8.8,53,udp,dns,54,97,1,81,1,178,2,normal,-
8527884909698478334,10.0.2.15,8.8.8.8,53,udp,dns,102,179,1,92,1,271,2,normal,-
-3517361494988027074,10.0.2.15,8.8.8.8,53,udp,dns,75,188,1,100,1,288,2,normal,-
7471018385760832174,10.0.2.15,8.8.8.8,53,udp,dns,61,162,1,98,1,260,2,normal,-
347232445917460273,10.0.2.15,8.8.8.8,53,udp,dns,54,163,1,102,1,265,2,normal,-
7450033792890550716,10.0.2.15,8.8.8.8,53,udp,dns,56,191,1,87,1,278,2,normal,-
3108320948169829653,10.0.2.15,104.19.154.83,443,udp,-,273,7744,13,2465,8,10209,21,normal,-
-6289741036173057427,10.0.2.15,8.8.8.8,53,udp,dns,62,127,1,99,1,226,2,normal,-
1006881046971662608,10.0.2.15,8.8.8.8,53,udp,dns,45,133,1,80,1,213,2,normal,-
-3304098772497555298,10.0.2.15,8.8.8.8,53,udp,dns,38,207,1,114,1,321,2,normal,-
4504849497092633715,10.0.2.15,8.8.8.8,53,udp,dns,50,230,1,91,1,321,2,normal,-
-2532022064850806991,10.0.2.15,8.8.8.8,53,udp,dns,92,113,1,84,1,197,2,normal,-
-2681161809647422796,10.0.2.15,8.8.8.8,53,udp,dns,74,171,1,84,1,255,2,normal,-
2833247315367891071,10.0.2.15,8.8.8.8,53,udp,dns,66,143,1,86,1,229,2,normal,-
5789077861573125558,10.0.2.15,8.8.8.8,53,udp,dns,58,141,1,82,1,223,2,normal,-
755379003261384390,10.0.2.15,8.8.8.8,53,udp,dns,65,186,1,99,1,285,2,normal,-
-4900817574357017308,10.0.2.15,8.8.8.8,53,udp,dns,36,206,1,95,1,301,2,normal,-
-4527927717307230683,10.0.2.15,8.8.8.8,53,udp,dns,82,112,1,80,1,192,2,normal,-
7290996722128757196,10.0.2.15,8.8.8.8,53,udp,dns,88,113,1,97,1,210,2,normal,-
5893978427678165654,10.0.2.15,8.8.8.8,53,udp,dns,51,208,1,85,1,293,2,normal,-
2587990462108609829,10.0.2.15,8.8.8.8,53,udp,dns,64,144,1,88,1,232,2,normal,-
1578413682920663632,10.0.2.15,8.8.8.8,53,udp,dns,521,324,1,100,1,424,2,normal,-
-5652771075279947135,10.0.2.15,142.251.36.78,443,udp,-,29094,25158,51,7946,35,33104,86,normal,-
164414567742533140,10.0.2.15,8.8.8.8,53,udp,dns,82,114,1,86,1,200,2,normal,-
1220813964087088546,10.0.2.15,8.8.8.8,53,udp,dns,91,239,1,95,1,334,2,normal,-
-536065102025348215,10.0.2.15,8.8.8.8,53,udp,dns,102,166,1,86,1,252,2,normal,-
-7483019665049313448,10.0.2.15,8.8.8.8,53,udp,dns,99,210,1,79,1,289,2,normal,-
-6710829177665753711,10.0.2.15,8.8.8.8,53,udp,dns,65,149,1,93,1,242,2,normal,-
-8606768516770527290,10.0.2.15,8.8.8.8,53,udp,dns,40,100,1,84,1,184,2,normal,-
-2454217531707121510,10.0.2.15,8.8.8.8,53,udp,dns,78,115,1,99,1,214,2,normal,-
7264669508106068221,10.0.2.15,8.8.8.8,53,udp,dns,52,127,1,99,1,226,2,normal,-
-9215661382111024095,10.0.2.15,8.8.8.8,53,udp,dns,40,146,1,81,1,227,2,normal,-
5234101294797599612,10.0.2.15,142.251.37.110,443,udp,-,5031,3111,11,3252,9,6363,20,normal,-
-7588781598419598147,10.0.2.15,8.8.8.8,53,udp,dns,79,116,1,84,1,200,2,normal,-
-8461790777354771149,10.0.2.15,8.8.8.8,53,udp,dns,49,132,1,87,1,219,2,normal,-
-3410210111746247594,10.0.2.15,8.8.8.8,53,udp,dns,38,95,1,79,1,174,2,normal,-
5576054193658114628,10.0.2.15,8.8.8.8,53,udp,dns,85,184,1,85,1,269,2,normal,-
2660614318205149620,10.0.2.15,216.239.34.36,443,udp,-,6570,8417,17,3270,12,11687,29,normal,-
5088048739649470049,10.0.2.15,52.97.135.98,443,udp,-,751,13297,11,3501,9,16798,20,normal,-
-6823814818042773621,10.0.2.15,34.107.204.85,443,udp,-,580,8901,12,3171,11,12072,23,normal,-
4400154399757085439,10.0.2.15,8.8.8.8,53,udp,dns,122,172,1,92,1,264,2,normal,-
5134106734133786302,10.0.2.15,8.8.8.8,53,udp,dns,77,102,1,86,1,188,2,normal,-
7113172473744228437,10.0.2.15,8.8.8.8,53,udp,dns,59,112,1,84,1,196,2,normal,-
6216071974387403179,10.0.2.15,8.8.8.8,53,udp,dns,105,184,1,99,1,283,2,normal,-
5987383730506380220,10.0.2.15,8.8.8.8,53,udp,dns,42,188,1,90,1,278,2,normal,-
112323204614195203,10.0.2.15,142.251.36.131,80,tcp,-,5706,180,3,236,4,416,7,normal,-
-8709182576493822264,10.0.2.15,8.8.8.8,53,udp,dns,67,105,1,89,1,194,2,normal,-
5191324736868593134,10.0.2.15,65.9.9.138,80,tcp,http,26449,1362,7,885,8,2247,15,normal,-
6407287377353066495,10.0.2.15,8.8.8.8,53,udp,dns,521,164,1,100,1,264,2,normal,-
1658385473939790985,10.0.2.15,8.8.8.8,53,udp,dns,93,191,1,92,1,283,2,normal,-
-855825850312699877,10.0.2.15,8.8.8.8,53,udp,dns,81,359,1,92,1,451,2,normal,-
8744960231691402177,10.0.2.15,8.8.8.8,53,udp,dns,63,131,1,99,1,230,2,normal,-
1653241873542447026,10.0.2.15,8.8.8.8,53,udp,dns,67,149,1,92,1,241,2,normal,-
-1933971042238826551,10.0.2.15,8.8.8.8,53,udp,dns,51,184,1,85,1,269,2,normal,-
-7806819649915431893,10.0.2.15,8.8.8.8,53,udp,dns,60,174,1,93,1,267,2,normal,-
7695029156026992054,10.0.2.15,8.8.8.8,53,udp,dns,51,179,1,98,1,277,2,normal,-
1359785567627308557,10.0.2.15,8.8.8.8,53,udp,dns,55,102,1,86,1,188,2,normal,-
-7644851140604989384,10.0.2.15,192.229.221.95,80,tcp,http,185286,11702,40,7322,41,19024,81,normal,-
5199471698195033179,10.0.2.15,142.251.36.67,443,udp,-,189,6985,8,2154,9,9139,17,normal,-
4016505849476876496,10.0.2.15,8.8.8.8,53,udp,dns,63,191,1,87,1,278,2,normal,-
3140129284977343636,10.0.2.15,8.8.8.8,53,udp,dns,63,135,1,86,1,221,2,normal,-
5744518266162299031,10.0.2.15,8.8.8.8,53,udp,dns,45,207,1,114,1,321,2,normal,-
-3848319861483429230,10.0.2.15,8.8.8.8,53,udp,dns,107,212,1,84,1,296,2,normal,-
-1443123226781667723,10.0.2.15,8.8.8.8,53,udp,dns,98,121,1,93,1,214,2,normal,-
3972791838861071145,10.0.2.15,192.229.221.25,443,tcp,-,3181,60,1,128,2,188,3,normal,-
-4563777988246055913,10.0.2.15,8.8.8.8,53,udp,dns,61,131,1,99,1,230,2,normal,-
-3470609531417064052,10.0.2.15,8.8.8.8,53,udp,dns,43,157,1,84,1,241,2,normal,-
752626791779240484,10.0.2.15,8.8.8.8,53,udp,dns,76,218,1,142,1,360,2,normal,-
-4800461067610013196,10.0.2.15,8.8.8.8,53,udp,dns,59,207,1,114,1,321,2,normal,-
494720401072637621,10.0.2.15,8.8.8.8,53,udp,dns,82,143,1,86,1,229,2,normal,-
6158390666848754553,10.0.2.15,8.8.8.8,53,udp,dns,90,190,1,84,1,274,2,normal,-
7994276485313952862,10.0.2.15,8.8.8.8,53,udp,dns,55,210,1,92,1,302,2,normal,-
-3952487778552950290,10.0.2.15,142.251.36.130,443,udp,-,163,2290,4,1629,3,3919,7,normal,-
-1708795406641818032,10.0.2.15,142.251.36.98,443,udp,-,1521,10603,14,2777,12,13380,26,normal,-
2669309577658676594,10.0.2.15,8.8.8.8,53,udp,dns,64,260,1,106,1,366,2,normal,-
-8292027262254817739,10.0.2.15,8.8.8.8,53,udp,dns,52,149,1,93,1,242,2,normal,-
-3547714332648781730,10.0.2.15,104.19.188.97,443,tcp,-,68,60,1,128,2,188,3,normal,-
7343335408514998305,10.0.2.15,8.8.8.8,53,udp,dns,63,100,1,84,1,184,2,normal,-
-8055067769232317887,10.0.2.15,8.8.8.8,53,udp,dns,68,170,1,90,1,260,2,normal,-
4171579935612873910,10.0.2.15,8.8.8.8,53,udp,dns,54,192,1,86,1,278,2,normal,-
4305443206318673604,10.0.2.15,8.8.8.8,53,udp,dns,65,125,1,93,1,218,2,normal,-
-3044746060919005798,10.0.2.15,8.8.8.8,53,udp,dns,63,152,1,92,1,244,2,normal,-
496372190714076078,10.0.2.15,8.8.8.8,53,udp,dns,153,108,1,92,1,200,2,normal,-
-1101792932017332569,10.0.2.15,8.8.8.8,53,udp,dns,90,167,1,86,1,253,2,normal,-
-4708954748416875612,10.0.2.15,8.8.8.8,53,udp,dns,41,141,1,85,1,226,2,normal,-
-4168162766577540458,10.0.2.15,13.107.42.14,443,tcp,-,36,60,1,128,2,188,3,normal,-
-876209733930725792,10.0.2.15,8.8.8.8,53,udp,dns,48,170,1,88,1,258,2,normal,-
-1256366473455029233,10.0.2.15,8.8.8.8,53,udp,dns,5054,180,1,190,2,370,3,normal,-
2084227341000321025,10.0.2.15,8.8.8.8,53,udp,dns,63,200,1,91,1,291,2,normal,-
-4062542238365709487,10.0.2.15,142.251.36.99,443,udp,-,189,9624,10,2064,8,11688,18,normal,-
-251142872288233141,10.0.2.15,8.8.8.8,53,udp,dns,88,170,1,88,1,258,2,normal,-
-8739207070041908561,10.0.2.15,8.8.8.8,53,udp,dns,82,112,1,84,1,196,2,normal,-
-7890772150123421410,10.0.2.15,8.8.8.8,53,udp,dns,71,142,1,81,1,223,2,normal,-
-6584944018690432157,10.0.2.15,8.8.8.8,53,udp,dns,46,124,1,92,1,216,2,normal,-
5867025394118526513,10.0.2.15,8.8.8.8,53,udp,dns,82,106,1,90,1,196,2,normal,-
-8413856862654005058,10.0.2.15,142.251.36.110,443,udp,-,173,9638,10,1984,7,11622,17,normal,-
-2265541564145783445,10.0.2.15,8.8.8.8,53,udp,dns,66,121,1,89,1,210,2,normal,-
5844096422917788989,10.0.2.15,157.240.30.35,443,udp,-,21450,717149,763,194576,384,911725,1147,normal,-
7266178298345791204,10.0.2.15,8.8.8.8,53,udp,dns,88,117,1,101,1,218,2,normal,-
-2667313194708675120,10.0.2.15,104.18.16.5,443,tcp,-,1056,60,1,128,2,188,3,normal,-
-2239428294413860693,10.0.2.15,8.8.8.8,53,udp,dns,67,148,1,92,1,240,2,normal,-
-5182037477481325336,10.0.2.15,8.8.8.8,53,udp,dns,98,148,1,92,1,240,2,normal,-
6283617358188357218,10.0.2.15,8.8.8.8,53,udp,dns,64,207,1,114,1,321,2,normal,-
4651055734215108114,10.0.2.15,8.8.8.8,53,udp,dns,134,161,1,100,1,261,2,normal,-
-6101603789860308259,10.0.2.15,142.251.36.70,443,tcp,-,65,60,1,128,2,188,3,normal,-
372680568111838587,10.0.2.15,8.8.8.8,53,udp,dns,47,152,1,96,1,248,2,normal,-
-5929468467678329995,10.0.2.15,8.8.8.8,53,udp,dns,178,171,1,89,1,260,2,normal,-
2300117000134287291,10.0.2.15,8.8.8.8,53,udp,dns,179,198,1,117,1,315,2,normal,-
225878731927927940,10.0.2.15,8.8.8.8,53,udp,dns,58,100,1,84,1,184,2,normal,-
-1863819255434891305,10.0.2.15,157.240.20.19,443,udp,-,122,5562,8,1996,7,7558,15,normal,-
-1610846850364986758,10.0.2.15,8.8.8.8,53,udp,dns,41,184,1,86,1,270,2,normal,-
8126213644239929611,10.0.2.15,8.8.8.8,53,udp,dns,54,126,1,98,1,224,2,normal,-
8587309182367238759,10.0.2.15,8.8.8.8,53,udp,dns,45,125,1,93,1,218,2,normal,-
-8898505967029638709,10.0.2.15,8.8.8.8,53,udp,dns,194,118,1,90,1,208,2,normal,-
-6805978446434689950,10.0.2.15,8.8.8.8,53,udp,dns,41,158,1,94,1,252,2,normal,-
-4438360124266162807,10.0.2.15,8.8.8.8,53,udp,dns,86,91,1,75,1,166,2,normal,-
-643592604773882801,10.0.2.15,8.8.8.8,53,udp,dns,55,147,1,84,1,231,2,normal,-
-1185244037879917564,10.0.2.15,8.8.8.8,53,udp,dns,58,141,1,82,1,223,2,normal,-
1141033345708251634,10.0.2.15,8.8.8.8,53,udp,dns,57,108,1,92,1,200,2,normal,-
2490176483096698923,10.0.2.15,8.8.8.8,53,udp,dns,121,197,1,133,1,330,2,normal,-
-8144311066679672789,10.0.2.15,8.8.8.8,53,udp,dns,52,315,1,87,1,402,2,normal,-
-2553943540462421148,10.0.2.15,142.251.36.99,443,udp,-,739,2902,8,2191,6,5093,14,normal,-
516995961017413683,10.0.2.15,8.8.8.8,53,udp,dns,120,190,1,142,1,332,2,normal,-
4204262691389506612,10.0.2.15,8.8.8.8,53,udp,dns,155,157,1,89,1,246,2,normal,-
-6147515508239445192,10.0.2.15,8.8.8.8,53,udp,dns,63,120,1,92,1,212,2,normal,-
-2072074216199261387,10.0.2.15,104.17.50.95,443,udp,-,30314,7525,14,4384,10,11909,24,normal,-
3532586501444950462,10.0.2.15,156.38.4.81,443,udp,-,1879,8060,13,2362,11,10422,24,normal,-
-3385299061223400909,10.0.2.15,8.8.8.8,53,udp,dns,39,214,1,85,1,299,2,normal,-
-7742493772592050208,10.0.2.15,8.8.8.8,53,udp,dns,298,259,1,125,1,384,2,normal,-
-7121644018030870680,10.0.2.15,157.240.30.27,443,udp,-,440,121376,102,4054,32,125430,134,normal,-
8370304805263365665,10.0.2.15,8.8.8.8,53,udp,dns,55,135,1,84,1,219,2,normal,-
5645943084439098315,10.0.2.15,8.8.8.8,53,udp,dns,43,161,1,100,1,261,2,normal,-
5870278150298971169,10.0.2.15,8.8.8.8,53,udp,dns,79,115,1,99,1,214,2,normal,-
-558815264273879560,10.0.2.15,8.8.8.8,53,udp,dns,79,101,1,85,1,186,2,normal,-
3679205605352926041,10.0.2.15,8.8.8.8,53,udp,dns,50,159,1,94,1,253,2,normal,-
7621689320420350997,10.0.2.15,8.8.8.8,53,udp,dns,259,244,1,91,1,335,2,normal,-
5885341848311968625,10.0.2.15,8.8.8.8,53,udp,dns,60,178,1,97,1,275,2,normal,-
39121978601289450,10.0.2.15,8.8.8.8,53,udp,dns,122,201,1,86,1,287,2,normal,-
-3435628076568521561,10.0.2.15,8.8.8.8,53,udp,dns,59,108,1,80,1,188,2,normal,-
8825008274663500207,10.0.2.15,8.8.8.8,53,udp,dns,417,160,1,89,1,249,2,normal,-
6444696411986943194,10.0.2.15,8.8.8.8,53,udp,dns,55,213,1,93,1,306,2,normal,-
-6999140714970600653,10.0.2.15,8.8.8.8,53,udp,dns,49,227,1,91,1,318,2,normal,-
6082532999275316459,10.0.2.15,8.8.8.8,53,udp,dns,82,149,1,92,1,241,2,normal,-
5410636549270984488,10.0.2.15,8.8.8.8,53,udp,dns,50,233,1,101,1,334,2,normal,-
-1489875190352630745,10.0.2.15,8.8.8.8,53,udp,dns,76,94,1,78,1,172,2,normal,-
-1346370973613673945,10.0.2.15,8.8.8.8,53,udp,dns,46,124,1,108,1,232,2,normal,-
-8268263608000233408,10.0.2.15,65.9.9.138,80,tcp,http,26203,1420,7,885,8,2305,15,normal,-
-349813171477978926,10.0.2.15,8.8.8.8,53,udp,dns,66,126,1,98,1,224,2,normal,-
8845093318175133600,10.0.2.15,192.229.221.25,443,tcp,-,2132,60,1,128,2,188,3,normal,-
-8500230457153250116,10.0.2.15,8.8.8.8,53,udp,dns,90,156,1,100,1,256,2,normal,-
-5703889980576036218,10.0.2.15,8.8.8.8,53,udp,dns,78,183,1,83,1,266,2,normal,-
6281939290049276570,10.0.2.15,8.8.8.8,53,udp,dns,53,102,1,86,1,188,2,normal,-
3762170666894205552,10.0.2.15,104.18.20.226,80,tcp,http,115690,2943,17,1438,18,4381,35,normal,-
-2172673332989100508,10.0.2.15,8.8.8.8,53,udp,dns,65,114,1,98,1,212,2,normal,-
-4677950060779323558,10.0.2.15,8.8.8.8,53,udp,dns,59,156,1,86,1,242,2,normal,-
7405151070098958783,10.0.2.15,8.8.8.8,53,udp,dns,56,202,1,89,1,291,2,normal,-
-2801641541999463763,10.0.2.15,8.8.8.8,53,udp,dns,62,177,1,84,1,261,2,normal,-
-3263897409741116395,10.0.2.15,104.18.32.68,80,tcp,http,18957,1320,6,822,7,2142,13,normal,-
-160489780942162481,10.0.2.15,8.8.8.8,53,udp,dns,47,148,1,92,1,240,2,normal,-
1824332882690125919,10.0.2.15,8.8.8.8,53,udp,dns,55,208,1,87,1,295,2,normal,-
804545127398023247,10.0.2.15,8.8.8.8,53,udp,dns,65,162,1,82,1,244,2,normal,-
2619896335733446520,10.0.2.15,34.120.202.204,443,udp,-,212,6162,8,2364,10,8526,18,normal,-
7593168570024577959,10.0.2.15,8.8.8.8,53,udp,dns,55,135,1,84,1,219,2,normal,-
-6768152090260713289,10.0.2.15,8.8.8.8,53,udp,dns,58,148,1,92,1,240,2,normal,-
5640694083873284157,10.0.2.15,34.107.221.82,80,tcp,http,190630,2190,26,2387,27,4577,53,normal,-
4996877928321340396,10.0.2.15,8.8.8.8,53,udp,dns,122,136,1,86,1,222,2,normal,-
2666975611023843163,10.0.2.15,8.8.8.8,53,udp,dns,70,111,1,95,1,206,2,normal,-
7464400094473741306,10.0.2.15,8.8.8.8,53,udp,dns,276,144,1,128,1,272,2,normal,-
-8245576822627091909,10.0.2.15,8.8.8.8,53,udp,dns,46,141,1,82,1,223,2,normal,-
-5680513998790554707,10.0.2.15,8.8.8.8,53,udp,dns,54,139,1,91,1,230,2,normal,-
-4156511130580910262,10.0.2.15,142.251.37.99,443,udp,-,200,6989,8,1901,6,8890,14,normal,-
-8053323803291596214,10.0.2.15,8.8.8.8,53,udp,dns,68,351,1,85,1,436,2,normal,-
1436166551549523183,10.0.2.15,8.8.8.8,53,udp,dns,67,129,1,90,1,219,2,normal,-
-7662504257009856797,10.0.2.15,8.8.8.8,53,udp,dns,58,112,1,84,1,196,2,normal,-
-2459779237983798680,10.0.2.15,142.251.36.132,443,udp,-,7086,18670,59,6492,49,25162,108,normal,-
2549550782310130862,10.0.2.15,8.8.8.8,53,udp,dns,59,151,1,91,1,242,2,normal,-
-1411066290541985187,10.0.2.15,8.8.8.8,53,udp,dns,54,97,1,81,1,178,2,normal,-
4878028382173209672,10.0.2.15,8.8.8.8,53,udp,dns,55,140,1,92,1,232,2,normal,-
8353040263568957311,10.0.2.15,8.8.8.8,53,udp,dns,68,114,1,86,1,200,2,normal,-
2741288333411623142,10.0.2.15,8.8.8.8,53,udp,dns,79,164,1,98,1,262,2,normal,-
9088320091993383657,10.0.2.15,8.8.8.8,53,udp,dns,81,150,1,89,1,239,2,normal,-
-4057623478222567056,10.0.2.15,8.8.8.8,53,udp,dns,310,212,1,83,1,295,2,normal,-
8946934327887487811,10.0.2.15,8.8.8.8,53,udp,dns,105685,270,2,173,2,443,4,normal,-
-6634887437287011057,10.0.2.15,8.8.8.8,53,udp,dns,61,181,1,79,1,260,2,normal,-
-2001644793209197961,10.0.2.15,8.8.8.8,53,udp,dns,50,167,1,83,1,250,2,normal,-
530798912431430453,10.0.2.15,8.8.8.8,53,udp,dns,50,146,1,81,1,227,2,normal,-
4427044963948948234,10.0.2.15,8.8.8.8,53,udp,dns,68,148,1,92,1,240,2,normal,-
6994145828844406165,10.0.2.15,8.8.8.8,53,udp,dns,44,113,1,97,1,210,2,normal,-
521993000360458361,10.0.2.15,142.251.36.78,443,udp,-,391,9741,11,2365,10,12106,21,normal,-
5452828697838358017,10.0.2.15,8.8.8.8,53,udp,dns,55,157,1,80,1,237,2,normal,-
-6731798847000332504,10.0.2.15,8.8.8.8,53,udp,dns,52,152,1,88,1,240,2,normal,-
-3884220105877582946,10.0.2.15,8.8.8.8,53,udp,dns,64,145,1,93,1,238,2,normal,-
-4978559638132926443,10.0.2.15,8.8.8.8,53,udp,dns,65,111,1,83,1,194,2,normal,-
1701178331759420057,10.0.2.15,8.8.8.8,53,udp,dns,65,173,1,77,1,250,2,normal,-
-7260038371734808268,10.0.2.15,8.8.8.8,53,udp,dns,78,114,1,86,1,200,2,normal,-
-8826283109613821591,10.0.2.15,8.8.8.8,53,udp,dns,68,102,1,86,1,188,2,normal,-
8326293197654976069,10.0.2.15,35.241.9.150,443,tcp,-,141,60,1,128,2,188,3,normal,-
-3091519627927497034,10.0.2.15,8.8.8.8,53,udp,dns,48,157,1,103,1,260,2,normal,-
4405736075484953802,10.0.2.15,8.8.8.8,53,udp,dns,259,195,1,111,1,306,2,normal,-
-1169728509213640607,10.0.2.15,8.8.8.8,53,udp,dns,57,253,1,94,1,347,2,normal,-
-6613140473492492221,10.0.2.15,8.8.8.8,53,udp,dns,45,112,1,96,1,208,2,normal,-
-6078932508068658774,10.0.2.15,8.8.8.8,53,udp,dns,74,311,1,87,1,398,2,normal,-
4152145335015660291,10.0.2.15,8.8.8.8,53,udp,dns,62,161,1,103,1,264,2,normal,-
5143626284202756148,10.0.2.15,8.8.8.8,53,udp,dns,76,141,1,90,1,231,2,normal,-
-4779428592804561333,10.0.2.15,8.8.8.8,53,udp,dns,50,141,1,84,1,225,2,normal,-
6974488730021850190,10.0.2.15,8.8.8.8,53,udp,dns,133,163,1,102,1,265,2,normal,-
-4631174434706755440,10.0.2.15,151.101.193.26,443,udp,-,2560,4710,7,2402,8,7112,15,normal,-
-5813405550928163047,10.0.2.15,8.8.8.8,53,udp,dns,66,151,1,95,1,246,2,normal,-
2752948198143582782,10.0.2.16,224.0.0.251,5353,udp,-,0,0,0,732,4,732,4,normal,-
-3543195396208485863,10.0.2.16,23.195.249.173,443,tcp,tls,20278,7878,18,1799,17,9677,35,normal,-
1706033712948924520,10.0.2.16,104.19.188.97,443,tcp,-,119,60,1,128,2,188,3,normal,-
8132642812690268212,10.0.2.16,142.251.36.97,443,tcp,tls,158,9718,14,1568,14,11286,28,normal,-
3885822459952322686,10.0.2.16,142.251.36.67,80,tcp,-,5953,180,3,236,4,416,7,normal,-
7635624270275342668,10.0.2.16,142.251.36.99,443,tcp,tls,508,44733,44,2710,28,47443,72,normal,-
-8190214549800914976,10.0.2.16,151.101.192.176,443,tcp,tls,166,5306,11,1460,12,6766,23,normal,-
-1898426450254782151,10.0.2.16,142.251.36.106,443,tcp,tls,170,2252,14,2200,13,4452,27,normal,-
-4094504915440045755,10.0.2.16,157.240.19.26,443,tcp,tls,931,6102,17,2184,16,8286,33,normal,-
-8059787243992564099,10.0.2.16,77.75.77.195,443,tcp,tls,782,6451,12,1476,12,7927,24,normal,-
3616186978898785391,10.0.2.16,157.240.30.18,443,tcp,tls,18765,3565,27,3549,24,7114,51,normal,-
3584266011859123046,10.0.2.16,147.229.9.226,443,tcp,tls,400,12600,19,2701,19,15301,38,normal,-
1910701377650757582,10.0.2.16,109.123.210.81,443,tcp,tls,290,6587,12,1536,12,8123,24,normal,-
-5828891016654049409,10.0.2.16,34.208.191.20,443,tcp,tls,10271,7910,31,9532,26,17442,57,normal,-
-8882864292607496966,10.0.2.16,142.251.36.67,80,tcp,-,5401,180,3,236,4,416,7,normal,-
-5128847876392044071,10.0.2.16,17.253.144.10,443,tcp,tls,230,5956,13,1610,11,7566,24,normal,-
-526697753457047205,10.0.2.16,142.251.36.106,443,tcp,tls,295,2258,14,2147,12,4405,26,normal,-
4863322405924470658,10.0.2.16,147.229.9.226,443,tcp,-,49,60,1,128,2,188,3,normal,-
7255405973987786025,10.0.2.16,77.75.77.195,443,tcp,tls,253,6473,12,1476,12,7949,24,normal,-
-9163688204112553054,10.0.2.16,77.75.79.195,443,tcp,tls,651,6451,12,1530,13,7981,25,normal,-
3977616889225175075,10.0.2.16,77.75.78.4,443,tcp,tls,276,6370,14,1514,13,7884,27,normal,-
8294526152647110169,10.0.2.16,77.75.79.195,443,tcp,tls,844,6374,12,1476,12,7850,24,normal,-
8456461240159269409,10.0.2.16,77.75.78.4,443,tcp,tls,238,6370,14,1514,13,7884,27,normal,-
8407133097388870295,10.0.2.16,65.9.94.165,443,tcp,tls,5491,6812,12,1327,13,8139,25,normal,-
8439165841146398239,10.0.2.16,77.75.79.195,443,tcp,tls,197,6445,12,1476,12,7921,24,normal,-
421854664558422797,10.0.2.16,77.75.77.195,443,tcp,tls,278,6527,13,1530,13,8057,26,normal,-
3987545037762592858,10.0.2.16,142.251.36.106,443,tcp,tls,191,2150,12,2148,12,4298,24,normal,-
-350170594197761960,10.0.2.16,77.75.78.4,443,tcp,tls,248,6370,14,1514,13,7884,27,normal,-
-8597511519505173031,10.0.2.16,142.251.36.106,443,tcp,tls,336,2090,11,2092,11,4182,22,normal,-
687158491469770217,10.0.2.16,77.75.77.195,443,tcp,tls,603,6445,12,1476,12,7921,24,normal,-
-275495416577434595,10.0.2.16,77.75.78.104,443,tcp,tls,13295,13041,23,5729,23,18770,46,normal,-
6492785263361822466,10.0.2.16,77.75.78.157,443,tcp,tls,322,6281,13,1568,14,7849,27,normal,-
-7468868901246947341,10.0.2.16,77.75.79.195,443,tcp,tls,363,6499,13,1584,14,8083,27,normal,-
4215996244491876202,10.0.2.16,216.239.34.36,443,tcp,tls,221,5977,12,1460,12,7437,24,normal,-
2466281457820378632,10.0.2.16,13.107.21.200,443,tcp,tls,231,8223,13,1622,13,9845,26,normal,-
7969259368407102580,10.0.2.16,147.229.9.226,443,tcp,-,53,60,1,128,2,188,3,normal,-
8402227943102682782,10.0.2.16,77.75.78.229,443,tcp,tls,606,6233,12,1460,12,7693,24,normal,-
1377514641512469182,10.0.2.16,77.75.76.101,443,tcp,tls,236,6363,14,1514,13,7877,27,normal,-
4657098400109255960,10.0.2.16,185.66.189.51,443,tcp,tls,235,6237,12,1460,12,7697,24,normal,-
-4737071151034793183,10.0.2.16,104.19.188.97,443,tcp,-,114,60,1,128,2,188,3,normal,-
-910032230483322743,10.0.2.16,147.229.9.226,443,tcp,-,45,60,1,128,2,188,3,normal,-
7572240904372950649,10.0.2.16,77.75.77.234,443,tcp,tls,265,6395,14,1514,13,7909,27,normal,-
-7971068359484435407,10.0.2.16,151.99.221.211,443,tcp,tls,486,6014,19,2293,18,8307,37,normal,-
891559163105725379,10.0.2.16,77.75.78.229,443,tcp,tls,399,6353,14,1514,13,7867,27,normal,-
9034737842618021714,10.0.2.16,104.19.188.97,443,tcp,-,116,60,1,128,2,188,3,normal,-
-8466684728855332107,10.0.2.16,87.244.225.145,443,tcp,tls,383,5677,17,2243,17,7920,34,normal,-
-660534130338294258,10.0.2.16,31.30.189.14,443,tcp,tls,115432,77126,71,4580,47,81706,118,normal,-
-3700502667651951939,10.0.2.16,77.75.77.195,443,tcp,tls,229,6451,12,1476,12,7927,24,normal,-
-9077552759796739136,10.0.2.16,142.251.36.106,443,tcp,tls,250,2150,12,2147,12,4297,24,normal,-
-8483437545005782008,10.0.2.16,77.75.78.36,443,tcp,tls,1598,6439,14,1514,13,7953,27,normal,-
-2793656293765420811,10.0.2.16,95.100.146.41,80,tcp,-,5287,180,3,236,4,416,7,normal,-
5066663136940490643,10.0.2.16,77.75.79.195,443,tcp,tls,612,6527,13,1584,14,8111,27,normal,-
-5019112671134359307,10.0.2.16,77.75.79.195,443,tcp,tls,165,6374,12,1476,12,7850,24,normal,-
1403145113534796663,10.0.2.16,104.16.57.101,443,tcp,tls,208,4087,11,1406,11,5493,22,normal,-
7056001892396830763,10.0.2.16,65.9.94.165,443,tcp,tls,5491,6812,12,1327,13,8139,25,normal,-
-5644949121478798979,10.0.2.16,109.123.210.81,443,tcp,tls,307,6673,13,1536,12,8209,25,normal,-
-8376366740457968487,10.0.2.16,142.251.36.106,443,tcp,tls,300,2204,13,2147,12,4351,25,normal,-
4002130854835562256,10.0.2.16,34.120.208.123,443,tcp,tls,382,4590,13,1251,13,5841,26,normal,-
-4695911912929209808,10.0.2.16,13.107.21.200,443,tcp,tls,133516,9686,25,3289,22,12975,47,normal,-
-374140783470880107,10.0.2.16,77.75.79.195,443,tcp,tls,1257,6451,12,1476,12,7927,24,normal,-
4573380682415713473,10.0.2.16,147.229.9.226,443,tcp,tls,33951,5942,16,2362,15,8304,31,normal,-
-1289540378820200236,10.0.2.16,147.229.9.226,443,tcp,-,47,60,1,128,2,188,3,normal,-
-7608404156256909439,10.0.2.16,142.251.36.106,443,tcp,tls,294,2204,13,2147,12,4351,25,normal,-
3038247104602736799,10.0.2.16,147.229.9.226,443,tcp,-,44,60,1,128,2,188,3,normal,-
-6043785240842551669,10.0.2.16,77.75.78.157,443,tcp,tls,330,6347,14,1514,13,7861,27,normal,-
1515459870305322304,10.0.2.16,65.9.95.67,443,tcp,tls,228,5012,11,1140,11,6152,22,normal,-
1071859717458070022,10.0.2.16,142.251.36.132,443,tcp,tls,170941,7281,22,2368,21,9649,43,normal,-
-5908344029607266827,10.0.2.16,142.251.36.106,443,tcp,tls,305,6820,16,2204,16,9024,32,normal,-
-6019489132169004442,10.0.2.16,34.107.221.82,80,tcp,http,175966,1964,23,1918,24,3882,47,normal,-
-4068315839297672463,10.0.2.16,142.251.37.104,443,tcp,tls,1147,95796,80,3118,36,98914,116,normal,-
8479552995822404103,10.0.2.16,142.251.37.110,443,tcp,tls,332,28298,35,3463,28,31761,63,normal,-
-4255131964335109991,10.0.2.16,77.75.79.195,443,tcp,tls,705,6467,12,1476,12,7943,24,normal,-
3118499182580122956,10.0.2.16,91.80.50.145,443,tcp,tls,498,5842,15,2184,16,8026,31,normal,-
6013971527295606232,10.0.2.16,104.17.50.95,443,tcp,tls,171035,4533,17,1861,17,6394,34,normal,-
-7753441688689304797,10.0.2.16,104.19.188.97,443,tcp,-,115,60,1,128,2,188,3,normal,-
-1114945754069591178,10.0.2.16,104.17.131.110,443,tcp,tls,170395,5680,19,2291,19,7971,38,normal,-
-3181869065002807895,10.0.2.16,142.251.36.67,80,tcp,http,115456,1656,16,1365,17,3021,33,normal,-
8921969034893679661,10.0.2.16,147.229.9.226,443,tcp,tls,3622,5441,13,2005,12,7446,25,normal,-
-3037347370526984703,10.0.2.16,13.107.21.200,443,tcp,tls,705,8397,16,1676,14,10073,30,normal,-
7791904831425525894,10.0.2.16,142.251.36.78,443,tcp,tls,256,8162,13,1514,13,9676,26,normal,-
5206971856185903567,10.0.2.16,31.30.189.14,443,tcp,tls,116460,123879,105,6256,76,130135,181,normal,-
8400958364762292523,10.0.2.16,2.16.2.192,443,tcp,tls,20234,5600,15,1637,14,7237,29,normal,-
321334518041922220,10.0.2.16,13.107.42.14,443,tcp,tls,525,5848,15,1622,13,7470,28,normal,-
-8145000870661155831,10.0.2.16,77.75.79.195,443,tcp,tls,457,6473,12,1530,13,8003,25,normal,-
7087041864164329236,10.0.2.16,77.75.78.104,443,tcp,tls,11347,24042,29,2873,20,26915,49,normal,-
5280076555224305334,10.0.2.16,65.9.95.112,443,tcp,-,38,60,1,128,2,188,3,normal,-
7681316709647604708,10.0.2.16,23.195.249.173,443,tcp,tls,952,7710,15,1584,14,9294,29,normal,-
3910938822738395850,10.0.2.16,13.107.42.14,443,tcp,tls,193,5674,12,1568,12,7242,24,normal,-
6781273387227925590,10.0.2.16,147.229.9.226,443,tcp,-,44,60,1,128,2,188,3,normal,-
-7425509910240906354,10.0.2.16,77.75.79.232,443,tcp,tls,546,6353,14,1568,14,7921,28,normal,-
-6731663810689801822,10.0.2.16,77.75.79.195,443,tcp,tls,251,6451,12,1476,12,7927,24,normal,-
3860893628988571770,10.0.2.16,142.251.36.106,443,tcp,tls,140,2324,15,2309,15,4633,30,normal,-
-8316926786086273254,10.0.2.16,77.75.78.36,443,tcp,tls,1237,6439,14,1514,13,7953,27,normal,-
2727616974947420911,10.0.2.16,192.229.221.95,80,tcp,-,6032,180,3,236,4,416,7,normal,-
-8614998314703973869,10.0.2.16,23.195.248.26,443,tcp,tls,200,8875,15,1638,15,10513,30,normal,-
4239035436333274411,10.0.2.16,77.75.77.195,443,tcp,tls,179,6467,12,1476,12,7943,24,normal,-
-9120353562077276105,10.0.2.16,142.251.37.99,443,tcp,tls,170736,5999,17,1861,17,7860,34,normal,-
-6710471509299743622,10.0.2.16,142.251.36.106,443,tcp,tls,151,2204,13,2148,12,4352,25,normal,-
4258470138831307792,10.0.2.16,95.100.146.41,80,tcp,http,130310,7857,28,4547,29,12404,57,normal,-
1357308976106265192,10.0.2.16,104.18.137.59,443,tcp,tls,171190,5465,18,2191,18,7656,36,normal,-
-8041476211909010293,10.0.2.16,77.75.78.4,443,tcp,tls,285,6370,14,1514,13,7884,27,normal,-
-4603008593632057784,10.0.2.16,77.75.77.195,443,tcp,tls,164,6521,13,1530,13,8051,26,normal,-
-7079436483556746385,10.0.2.16,142.251.37.99,443,tcp,tls,171161,6082,18,1915,18,7997,36,normal,-
8767613253870287029,10.0.2.16,13.107.42.14,443,tcp,tls,255,5794,14,1622,13,7416,27,normal,-
587818786006396309,10.0.2.16,77.75.79.195,443,tcp,-,1050,60,1,128,2,188,3,normal,-
2427020166122912344,10.0.2.16,77.75.79.195,443,tcp,tls,318,6467,12,1476,12,7943,24,normal,-
-7664959630369589726,10.0.2.16,77.75.79.195,443,tcp,tls,695,6451,12,1530,13,7981,25,normal,-
6452892224243613877,10.0.2.16,104.244.42.195,443,tcp,tls,178508,5203,20,2906,21,8109,41,normal,-
-4350474242580537307,10.0.2.16,34.107.204.85,443,tcp,tls,356,6009,13,1568,14,7577,27,normal,-
8425844662820484804,10.0.2.16,31.13.66.19,443,tcp,tls,742,6375,18,2180,16,8555,34,normal,-
-4088621205415601237,10.0.2.16,77.75.79.195,443,tcp,tls,498,6521,13,1530,13,8051,26,normal,-
414037750286533071,10.0.2.16,104.16.57.101,443,tcp,tls,178986,8170,64,44439,63,52609,127,normal,-
-7468591373822157530,10.0.2.16,95.100.146.41,80,tcp,http,130333,8857,30,5078,31,13935,61,normal,-
3223635215120395133,10.0.2.16,142.251.37.110,443,tcp,tls,171048,8641,20,1969,19,10610,39,normal,-
5753364047776509820,10.0.2.16,65.9.94.165,443,tcp,tls,5491,6812,12,1327,13,8139,25,normal,-
-3087556890590417270,10.0.2.16,77.75.78.104,443,tcp,tls,10312,7669,14,2907,12,10576,26,normal,-
-5376609531529292724,10.0.2.16,151.101.192.176,443,tcp,tls,178849,42035,53,3767,37,45802,90,normal,-
-3148780575633351842,10.0.2.16,147.229.9.226,443,tcp,-,53,60,1,128,2,188,3,normal,-
7476048238010917887,10.0.2.16,77.75.78.36,443,tcp,tls,1033,6439,14,1514,13,7953,27,normal,-
-5776146734189948275,10.0.2.16,77.75.78.104,443,tcp,tls,11042,12843,20,4416,20,17259,40,normal,-
-5791185499906645458,10.0.2.16,77.75.79.195,443,tcp,tls,264,6527,13,1530,13,8057,26,normal,-
7627281650668289046,10.0.2.16,147.229.9.226,443,tcp,tls,4177,10672,22,3242,20,13914,42,normal,-
2387093886209359358,10.0.2.16,142.251.36.67,80,tcp,http,117756,2472,18,1900,19,4372,37,normal,-
7514089279292707402,10.0.2.16,77.75.79.195,443,tcp,tls,226,6490,13,1530,13,8020,26,normal,-
7706153973978463501,10.0.2.16,77.75.76.36,443,tcp,tls,664,6493,15,1622,15,8115,30,normal,-
6279023909338357099,10.0.2.16,77.75.78.229,443,tcp,-,1044,60,1,128,2,188,3,normal,-
4631703378820257418,10.0.2.16,35.244.181.201,443,tcp,tls,170628,5661,22,2204,20,7865,42,normal,-
-2516811214328700990,10.0.2.16,142.251.36.106,443,tcp,tls,216,2150,12,2149,12,4299,24,normal,-
-5918272178144684610,10.0.2.16,77.75.78.4,443,tcp,tls,276,6370,14,1514,13,7884,27,normal,-
-8654644868873063616,10.0.2.16,109.123.210.81,443,tcp,tls,252,6619,12,1536,12,8155,24,normal,-
-8220758195692244782,10.0.2.16,77.75.78.104,443,tcp,tls,13181,24043,29,2931,26,26974,55,normal,-
1894818874698194438,10.0.2.16,142.251.36.78,443,tcp,tls,290,8162,13,1514,13,9676,26,normal,-
7729953069421038771,10.0.2.16,23.195.249.173,443,tcp,-,46,60,1,128,2,188,3,normal,-
1298377547864686654,10.0.2.16,142.251.36.106,443,tcp,tls,203,2312,15,2256,14,4568,29,normal,-
188852541591901101,10.0.2.16,77.75.79.232,443,tcp,tls,245,6407,15,1568,14,7975,29,normal,-
-6871998490311758026,10.0.2.16,91.198.174.208,443,tcp,tls,266,5169,11,1368,10,6537,21,normal,-
-8427918977963946550,10.0.2.16,162.159.136.232,443,tcp,tls,432,17243,23,2383,17,19626,40,normal,-
-1711318199529577983,10.0.2.16,142.251.36.106,443,tcp,tls,321,2204,13,2146,12,4350,25,normal,-
1803676659514128221,10.0.2.16,31.13.81.13,443,tcp,tls,449,6019,19,2247,17,8266,36,normal,-
802581960627163139,10.0.2.16,157.240.30.18,443,tcp,tls,18347,1871,19,3110,18,4981,37,normal,-
-5559001682051682194,10.0.2.16,8.8.8.8,53,udp,dns,60,207,1,114,1,321,2,normal,-
6720956943789447476,10.0.2.16,65.9.95.25,443,tcp,tls,786,6944,13,1514,13,8458,26,normal,-
2178548093754662519,10.0.2.16,77.75.78.104,443,tcp,tls,10225,7783,16,3069,15,10852,31,normal,-
4888944701045317931,10.0.2.16,142.251.36.67,80,tcp,http,131827,9009,34,6191,35,15200,69,normal,-
271086316697556504,10.0.2.16,8.8.8.8,53,udp,dns,53,354,1,87,1,441,2,normal,-
2731971148430935841,10.0.2.16,77.75.79.234,443,tcp,tls,249,6449,15,1568,14,8017,29,normal,-
-1840646783657125225,10.0.2.16,140.82.121.3,443,tcp,tls,15395,3902,14,1567,13,5469,27,normal,-
4200934249640414936,10.0.2.16,8.8.8.8,53,udp,dns,46,143,1,75,1,218,2,normal,-
8126929549260424013,10.0.2.16,8.8.8.8,53,udp,dns,90,230,1,90,1,320,2,normal,-
-6308742413484338789,10.0.2.16,65.9.95.25,443,tcp,tls,543,7080,15,1568,14,8648,29,normal,-
1630433750288334719,10.0.2.16,8.8.8.8,53,udp,dns,42,116,1,84,1,200,2,normal,-
8375160461910437640,10.0.2.16,142.251.36.142,443,tcp,tls,364,8162,13,1514,13,9676,26,normal,-
7029011232857745070,10.0.2.16,151.101.193.140,443,tcp,tls,178281,5947,23,2899,22,8846,45,normal,-
-7456619089295536421,10.0.2.16,8.8.8.8,53,udp,dns,47,149,1,93,1,242,2,normal,-
-2359366005056328502,10.0.2.16,142.251.37.110,443,udp,-,322,9741,11,2361,10,12102,21,normal,-
-1746327536384321283,10.0.2.16,142.251.37.110,443,udp,-,8342,9828,36,8045,29,17873,65,normal,-
-1888790659274050691,10.0.2.16,8.8.8.8,53,udp,dns,37,162,1,82,1,244,2,normal,-
-62233218237531787,10.0.2.16,8.8.8.8,53,udp,dns,128,120,1,88,1,208,2,normal,-
-1906502488729583918,10.0.2.16,34.117.237.239,443,tcp,tls,170825,6877,22,2464,23,9341,45,normal,-
7452403782332787345,10.0.2.16,104.18.26.222,443,tcp,tls,116889,64229,71,7583,43,71812,114,normal,-
5071582260135901803,10.0.2.16,8.8.8.8,53,udp,dns,115,132,1,87,1,219,2,normal,-
-1068196418678089475,10.0.2.16,8.8.8.8,53,udp,dns,119,200,1,90,1,290,2,normal,-
-8845253523080787208,10.0.2.16,8.8.8.8,53,udp,dns,50,208,1,85,1,293,2,normal,-
5983088763873423053,10.0.2.16,91.198.174.192,443,tcp,tls,215,5139,11,1422,11,6561,22,normal,-
8251631559158319164,10.0.2.16,142.251.36.129,443,tcp,tls,767,12417,22,2270,19,14687,41,normal,-
6632557516553297005,10.0.2.16,157.240.30.18,443,tcp,tls,14741,63422,115,10988,98,74410,213,normal,-
5873750355793104519,10.0.2.16,91.198.174.208,443,tcp,tls,324,5281,13,1476,12,6757,25,normal,-
2848929399789879835,10.0.2.16,216.239.32.36,443,tcp,tls,361,6666,18,3073,17,9739,35,normal,-
-7811422506542135828,10.0.2.16,142.251.36.78,443,tcp,tls,170471,8643,20,2023,20,10666,40,normal,-
-5931244116126990439,10.0.2.16,8.8.8.8,53,udp,dns,97,186,1,84,1,270,2,normal,-
-7373944109679943901,10.0.2.16,8.8.8.8,53,udp,dns,96,151,1,91,1,242,2,normal,-
-7881948154942131553,10.0.2.16,77.75.78.157,443,tcp,tls,452,6347,14,1568,14,7915,28,normal,-
-3897823881958389572,10.0.2.16,198.47.127.20,443,tcp,tls,170450,6465,21,2603,20,9068,41,normal,-
-4093196876822950751,10.0.2.16,77.75.78.4,443,tcp,tls,238,6250,12,1460,12,7710,24,normal,-
-4010423883871474522,10.0.2.16,8.8.8.8,53,udp,dns,39,150,1,96,1,246,2,normal,-
4867892568016894768,10.0.2.16,8.8.8.8,53,udp,dns,43,260,1,106,1,366,2,normal,-
3335533625068552816,10.0.2.16,77.75.79.115,443,tcp,tls,170617,34563,42,2670,27,37233,69,normal,-
-4137526441003122746,10.0.2.16,77.75.77.63,443,tcp,tls,170636,7549,22,2471,22,10020,44,normal,-
6600636549513634660,10.0.2.16,147.229.9.226,443,tcp,-,46,60,1,128,2,188,3,normal,-
3246993043388647028,10.0.2.16,142.251.37.106,443,udp,-,5327,7518,10,2377,9,9895,19,normal,-
-4814513339990148717,10.0.2.16,104.16.132.229,443,udp,-,152,5449,11,2118,8,7567,19,normal,-
8505953273943517287,10.0.2.16,157.240.30.27,443,tcp,tls,296,34540,36,2366,23,36906,59,normal,-
-8597597793112320667,10.0.2.16,77.75.76.4,443,tcp,tls,172697,89551,104,6410,60,95961,164,normal,-
-788155466519027017,10.0.2.16,141.95.47.54,443,tcp,tls,314,4383,12,1482,11,5865,23,normal,-
-8822955136763542904,10.0.2.16,185.66.189.42,443,tcp,tls,170598,8577,23,2426,21,11003,44,normal,-
-1192975967853203544,10.0.2.16,65.9.95.115,443,tcp,-,112,60,1,128,2,188,3,normal,-
-5708698630859597517,10.0.2.16,147.229.9.226,443,tcp,-,44,60,1,128,2,188,3,normal,-
-6935724008639815514,10.0.2.16,8.8.8.8,53,udp,dns,71,152,1,95,1,247,2,normal,-
5492607596157725017,10.0.2.16,8.8.8.8,53,udp,dns,47,146,1,82,1,228,2,normal,-
-1575212295966822935,10.0.2.16,8.8.8.8,53,udp,dns,54,146,1,81,1,227,2,normal,-
8105381606220968735,10.0.2.16,8.8.8.8,53,udp,dns,75,111,1,95,1,206,2,normal,-
-2168490977177584649,10.0.2.16,37.252.171.21,443,tcp,tls,10772,5874,15,2501,13,8375,28,normal,-
7814261209157028690,10.0.2.16,91.198.174.192,443,tcp,tls,227,5222,12,1422,11,6644,23,normal,-
-3628826486593383136,10.0.2.16,104.244.42.5,443,tcp,tls,177975,5057,22,2982,22,8039,44,normal,-
-6420963139725643546,10.0.2.16,8.8.8.8,53,udp,dns,54,170,1,88,1,258,2,normal,-
5116272275035756598,10.0.2.16,142.251.36.97,443,tcp,tls,170201,10204,21,2023,20,12227,41,normal,-
3692267857868046239,10.0.2.16,77.75.78.157,443,tcp,tls,171244,7893,24,2605,23,10498,47,normal,-
-2160605814410249927,10.0.2.16,142.251.36.142,443,tcp,tls,364,8161,13,1514,13,9675,26,normal,-
-3575920618566448935,10.0.2.16,142.251.37.110,443,udp,-,253,10574,14,2979,11,13553,25,normal,-
-213214204111075791,10.0.2.16,54.77.173.110,443,tcp,tls,421,347,4,807,5,1154,9,normal,-
-1752630011146561115,10.0.2.16,77.75.76.104,443,tcp,tls,116134,28640,41,2751,32,31391,73,normal,-
-5256406252268139459,10.0.2.16,74.115.50.110,443,tcp,tls,19257,60167,60,7844,44,68011,104,normal,-
-4777901176832254182,10.0.2.16,151.101.193.46,443,tcp,tls,384,6062,11,1460,12,7522,23,normal,-
-271268797431675902,10.0.2.16,185.80.39.216,443,tcp,tls,1413,8436,17,2547,18,10983,35,normal,-
4770963664109085938,10.0.2.16,77.75.77.222,443,tcp,tls,184064,126088,124,11549,86,137637,210,normal,-
-1986063364235539635,10.0.2.16,192.0.72.29,443,tcp,tls,48913,5207,13,1567,13,6774,26,normal,-
3100597350303646118,10.0.2.16,77.75.78.101,443,tcp,tls,241389,86315,127,16491,85,102806,212,normal,-
4251879896034118914,10.0.2.16,65.9.94.226,443,tcp,tls,102751,40199,43,2681,27,42880,70,normal,-
-2642200095258736542,10.0.2.16,156.40.212.210,443,tcp,tls,448,6652,11,1342,12,7994,23,normal,-
-2465394861551480884,10.0.2.16,34.254.143.3,443,tcp,tls,171,3268,6,861,6,4129,12,normal,-
-7753075776487156335,10.0.2.16,104.18.43.158,443,tcp,tls,104823,5240,20,2262,18,7502,38,normal,-
8281099324834605233,10.0.2.16,91.198.174.208,443,tcp,tls,111551,121107,112,8861,91,129968,203,normal,-
5684760820870251449,10.0.2.16,65.9.9.138,80,tcp,http,38948,2484,9,1426,10,3910,19,normal,-
-1142981201659583794,10.0.2.16,157.240.30.63,443,tcp,tls,708,1418668,983,19368,307,1438036,1290,normal,-
-8656834972497690909,10.0.2.16,52.94.235.74,443,tcp,tls,37584,7863,17,2157,17,10020,34,normal,-
4986655037000437404,10.0.2.16,52.167.30.171,443,tcp,tls,125185,18057,27,3616,20,21673,47,normal,-
-3251428120188906334,10.0.2.16,209.54.182.161,443,tcp,tls,5610,6691,12,1396,13,8087,25,normal,-
1022704437071565630,10.0.2.16,35.167.180.67,443,tcp,tls,36459,7187,22,5194,21,12381,43,normal,-
-6773289452662463989,10.0.2.16,77.75.79.129,443,tcp,tls,171038,7371,24,2625,24,9996,48,normal,-
-7039582083984559359,10.0.2.16,142.251.36.142,443,tcp,tls,80364,5918,16,1822,17,7740,33,normal,-
-7700056367150817640,10.0.2.16,142.251.36.132,443,tcp,tls,141169,5992,17,1861,17,7853,34,normal,-
-8562777644352253977,10.0.2.16,54.155.194.178,443,tcp,tls,655,3104,5,861,6,3965,11,normal,-
-5249425222732357883,10.0.2.16,34.117.237.239,443,tcp,tls,30632,6571,18,2116,18,8687,36,normal,-
-5333596936410768739,10.0.2.16,142.251.37.110,443,tcp,tls,732,14854,24,2410,23,17264,47,normal,-
7620747936268188797,10.0.2.16,200.147.35.149,443,tcp,tls,116700,5182,23,2595,23,7777,46,normal,-
3226656096440991021,10.0.2.16,91.198.174.208,443,tcp,tls,326,5169,11,1368,10,6537,21,normal,-
1005138407462933201,10.0.2.16,52.3.74.27,443,tcp,tls,734,6533,13,1644,14,8177,27,normal,-
-1142638723191108871,10.0.2.16,185.199.108.154,443,tcp,tls,227,4834,10,1406,11,6240,21,normal,-
-6469740312183941195,10.0.2.16,34.120.208.123,443,tcp,tls,329631,35729,210,79347,182,115076,392,normal,-
-80709029656211348,10.0.2.16,157.240.30.174,443,tcp,tls,225,4489,12,1460,12,5949,24,normal,-
-4222896874058836783,10.0.2.16,142.251.37.106,443,tcp,tls,77983,12240,22,2513,21,14753,43,normal,-
-4946676842430020040,10.0.2.16,186.192.90.12,443,tcp,tls,66383,6198,16,1838,17,8036,33,normal,-
-7659873618476378321,10.0.2.16,65.9.95.25,443,tcp,tls,765,6944,13,1568,14,8512,27,normal,-
-8067766451089816128,10.0.2.16,34.248.91.210,443,tcp,tls,141463,8935,28,4568,29,13503,57,normal,-
228480145580467342,10.0.2.16,198.54.12.127,443,tcp,tls,415,3268,6,861,6,4129,12,normal,-
2818659398646757750,10.0.2.16,151.101.193.16,443,tcp,tls,179,3164,6,861,6,4025,12,normal,-
-7329827220464440831,10.0.2.16,95.100.146.83,443,tcp,tls,34994,5696,13,1795,14,7491,27,normal,-
3051701094913766519,10.0.2.16,77.75.79.195,443,tcp,tls,310,6451,12,1476,12,7927,24,normal,-
8024944592788456734,10.0.2.16,185.66.189.42,443,tcp,tls,240818,62686,84,7484,69,70170,153,normal,-
5846834810489912993,10.0.2.16,13.107.238.45,443,tcp,tls,128351,19959,31,3352,30,23311,61,normal,-
4022641929648066036,10.0.2.16,3.120.0.25,443,tcp,tls,36934,7345,19,2227,18,9572,37,normal,-
-6943079279646613127,10.0.2.16,34.160.236.64,443,tcp,tls,3018,5609,18,2391,18,8000,36,normal,-
4442969922593147241,10.0.2.16,142.251.36.131,443,tcp,tls,201,5602,11,1406,11,7008,22,normal,-
7036884852677146283,10.0.2.16,65.9.95.109,443,tcp,tls,36507,11713,19,2246,18,13959,37,normal,-
8697276236727687815,10.0.2.16,147.67.210.45,443,tcp,tls,6019,3900,9,1165,10,5065,19,normal,-
2449709871694048472,10.0.2.16,198.47.127.19,443,tcp,tls,300,1642,4,807,5,2449,9,normal,-
-2048627574444791860,10.0.2.16,65.9.95.112,443,tcp,tls,142394,7488,20,2023,20,9511,40,normal,-
8689904221258785069,10.0.2.16,65.9.95.112,443,tcp,tls,141400,15573,26,2526,23,18099,49,normal,-
-6501728402792073072,10.0.2.16,34.254.143.3,443,tcp,tls,35078,4802,16,2089,16,6891,32,normal,-
-6589736911137277014,10.0.2.16,35.157.238.50,443,tcp,tls,14838,7368,21,2332,17,9700,38,normal,-
515583340742641311,10.0.2.16,157.240.30.63,443,tcp,tls,189,4120,11,1352,10,5472,21,normal,-
6571094432525236312,10.0.2.16,95.100.146.24,443,tcp,tls,122736,7166,28,5089,26,12255,54,normal,-
-192038956167974732,10.0.2.16,77.75.76.30,443,tcp,tls,252125,407030,458,85997,381,493027,839,normal,-
-3070586371001424378,10.0.2.16,151.101.193.51,443,tcp,tls,37836,7372,17,2906,17,10278,34,normal,-
-2647709094346812082,10.0.2.16,34.212.202.41,443,tcp,tls,15241,6542,15,1765,15,8307,30,normal,-
928806429358867955,10.0.2.16,34.212.202.41,443,tcp,tls,15237,6925,18,2336,18,9261,36,normal,-
-4141771894540629947,10.0.2.16,13.107.21.200,443,tcp,tls,92,3268,6,861,6,4129,12,normal,-
4395574932829780797,10.0.2.16,65.9.95.38,443,tcp,tls,316,6463,12,1514,13,7977,25,normal,-
5552078302689317774,10.0.2.16,65.9.95.81,443,tcp,tls,35668,8199,21,2464,21,10663,42,normal,-
-186243565605425007,10.0.2.16,3.89.18.11,443,tcp,tls,601,6167,9,1257,11,7424,20,normal,-
7609763176394101055,10.0.2.16,34.117.65.55,443,tcp,tls,329362,1993,14,2290,13,4283,27,normal,-
-6888474942643717506,10.0.2.16,142.251.36.138,443,tcp,tls,171130,6498,19,1969,19,8467,38,normal,-
-3593589824999142971,10.0.2.16,151.101.193.16,443,tcp,tls,215,3164,6,861,6,4025,12,normal,-
-6975805945979176236,10.0.2.16,77.75.79.195,443,tcp,tls,171,6521,13,1530,13,8051,26,normal,-
4490772602305113449,10.0.2.16,35.157.238.50,443,tcp,tls,391,5782,10,1257,11,7039,21,normal,-
-3471323983346664607,10.0.2.16,34.117.65.55,443,tcp,tls,170403,6252,18,1969,19,8221,37,normal,-
-721888295736814376,10.0.2.16,212.82.100.182,443,tcp,tls,485,3268,6,861,6,4129,12,normal,-
5922205814131512944,10.0.2.16,185.66.189.51,443,tcp,tls,171277,9739,42,6026,36,15765,78,normal,-
5741944513680612465,10.0.2.16,140.82.121.4,443,tcp,tls,60711,49440,52,3516,32,52956,84,normal,-
-7904988473381264589,10.0.2.16,109.123.210.74,443,tcp,tls,170337,7505,21,2509,20,10014,41,normal,-
2974472573392605433,10.0.2.16,34.98.64.218,443,tcp,tls,230,3712,7,915,7,4627,14,normal,-
4607545577907131220,10.0.2.16,147.229.9.226,443,tcp,tls,540,21868,32,4040,22,25908,54,normal,-
3743950717566197838,10.0.2.16,142.251.36.98,443,tcp,tls,170897,6350,19,1969,19,8319,38,normal,-
-7582505352335409815,10.0.2.16,77.75.79.15,443,tcp,tls,171073,7903,24,3258,23,11161,47,normal,-
8956693338179501610,10.0.2.16,142.251.36.67,443,tcp,tls,607,8098,25,3552,23,11650,48,normal,-
-6646610030006947129,10.0.2.16,157.240.30.63,443,tcp,tls,183,4120,11,1352,10,5472,21,normal,-
7713166206914912626,10.0.2.16,142.251.36.106,443,tcp,tls,652,6017,12,1514,13,7531,25,normal,-
-8496593279179268996,10.0.2.16,65.9.95.67,443,tcp,tls,199975,12486,28,3414,24,15900,52,normal,-
-5748017095549628347,10.0.2.16,91.198.174.192,443,tcp,tls,450,5189,12,1422,11,6611,23,normal,-
5181456733812216006,10.0.2.16,77.75.77.195,443,tcp,tls,170981,24349,33,2668,26,27017,59,normal,-
6981885980270574887,10.0.2.16,23.195.248.26,443,tcp,tls,240,9050,17,1692,16,10742,33,normal,-
3307175980324055153,10.0.2.16,37.157.5.141,443,tcp,tls,35578,7444,19,2541,20,9985,39,normal,-
8215567604432175900,10.0.2.16,142.251.37.106,443,tcp,tls,178,2204,13,2148,12,4352,25,normal,-
7056177371151175482,10.0.2.16,13.107.21.200,443,tcp,tls,133153,14446,36,5198,34,19644,70,normal,-
7525265763200132475,10.0.2.16,52.46.154.73,443,tcp,tls,39807,7904,19,3388,19,11292,38,normal,-
-8489232544095424966,10.0.2.16,142.251.36.78,443,tcp,tls,567,9639,19,3364,18,13003,37,normal,-
-1190315179793814217,10.0.2.16,142.251.36.97,443,tcp,tls,838,14007,34,3904,32,17911,66,normal,-
-8144480512641761411,10.0.2.16,104.18.26.222,443,tcp,tls,116701,97690,89,6149,60,103839,149,normal,-
252136835248532477,10.0.2.16,109.123.210.81,443,tcp,tls,171365,316017,236,12710,201,328727,437,normal,-
3755283640350836265,10.0.2.16,77.75.76.101,443,tcp,tls,251925,76187,128,22630,104,98817,232,normal,-
-6903370326280263692,10.0.2.16,157.240.252.60,443,tcp,tls,148335,4774,21,2023,20,6797,41,normal,-
-5097254334649432815,10.0.2.16,104.18.26.222,443,tcp,tls,116557,42827,48,3126,31,45953,79,normal,-
-6254952383234595106,10.0.2.16,34.250.135.14,443,tcp,tls,60475,7402,21,2231,20,9633,41,normal,-
-3884202508931986462,10.0.2.16,45.79.188.190,443,tcp,tls,797,6347,9,1203,10,7550,19,normal,-
3310961995703803661,10.0.2.16,13.107.238.44,443,tcp,tls,125646,5329,15,1758,14,7087,29,normal,-
4482815848783312640,10.0.2.16,69.173.144.139,443,tcp,tls,35074,4763,15,2025,16,6788,31,normal,-
5179836794002523881,10.0.2.16,142.251.36.99,443,tcp,tls,346,22818,31,3006,22,25824,53,normal,-
-472538733174266655,10.0.2.16,13.107.238.45,443,tcp,tls,125861,7510,18,1920,17,9430,35,normal,-
-3118044276616857511,10.0.2.16,23.195.248.26,443,tcp,tls,20251,9164,19,1745,16,10909,35,normal,-
-2991370830663022527,10.0.2.16,198.143.164.252,443,tcp,tls,60378,5557,18,1768,16,7325,34,normal,-
-7239267411713348397,10.0.2.16,142.251.37.106,443,tcp,tls,240,11370,16,1676,16,13046,32,normal,-
-5512069586039468449,10.0.2.16,95.100.146.34,443,tcp,tls,128443,10486,27,2756,25,13242,52,normal,-
-4909318508105404145,10.0.2.16,142.251.37.110,443,tcp,tls,720,11547,21,3062,18,14609,39,normal,-
-7344938536403534816,10.0.2.16,65.9.9.138,80,tcp,http,38948,2544,9,1426,10,3970,19,normal,-
4057895294401289950,10.0.2.16,95.100.146.82,443,tcp,tls,20366,5133,15,1529,12,6662,27,normal,-
-4935039020626157480,10.0.2.16,142.251.36.138,443,tcp,tls,74894,12272,23,2606,23,14878,46,normal,-
2204270228594612203,10.0.2.16,65.9.95.89,443,tcp,tls,137170,10284,22,2657,22,12941,44,normal,-
3399826673373585604,10.0.2.16,142.251.37.99,443,tcp,tls,357,5602,11,1406,11,7008,22,normal,-
-6060448783748324039,10.0.2.16,20.189.173.5,443,tcp,tls,119561,12182,59,46350,60,58532,119,normal,-
-7151166848694026713,10.0.2.16,77.75.77.195,443,tcp,tls,171974,27309,35,3229,36,30538,71,normal,-
555987338727394746,10.0.2.16,142.251.36.67,80,tcp,http,6102,1197,4,631,5,1828,9,normal,-
6957743287833002781,10.0.2.16,142.251.36.99,443,tcp,tls,125056,6081,18,1915,18,7996,36,normal,-
-1771219298820471060,10.0.2.16,52.94.235.74,443,tcp,tls,36896,10180,24,8499,23,18679,47,normal,-
-5888136206721308865,10.0.2.16,142.251.37.106,443,tcp,tls,489,13358,22,4309,22,17667,44,normal,-
6095986132104665167,10.0.2.16,198.54.12.127,443,tcp,tls,1615,4685,11,1843,12,6528,23,normal,-
4588217449341504305,10.0.2.16,142.251.36.67,443,tcp,tls,551,8644,18,2626,16,11270,34,normal,-
-1625083077310834550,10.0.2.16,77.75.78.104,443,tcp,tls,10415,9079,16,3135,16,12214,32,normal,-
-211345538505792229,10.0.2.16,91.198.174.192,443,tcp,tls,228,5153,11,1368,10,6521,21,normal,-
-2189582409596100646,10.0.2.16,77.75.78.104,443,tcp,tls,10192,7739,15,2999,14,10738,29,normal,-
623689648195159714,10.0.2.16,151.101.193.46,443,tcp,tls,640,6206,13,1514,13,7720,26,normal,-
1764592198162035592,10.0.2.16,3.76.234.99,443,tcp,tls,35778,7781,19,2309,19,10090,38,normal,-
720630223597970616,10.0.2.16,77.75.76.20,443,tcp,tls,171502,7223,21,2368,20,9591,41,normal,-
-5141441833833637100,10.0.2.16,185.199.108.154,443,tcp,tls,213,4919,12,1460,12,6379,24,normal,-
1474625507456178730,10.0.2.16,193.189.143.34,443,tcp,tls,30198,7729,15,1745,16,9474,31,normal,-
294490233523105319,10.0.2.16,13.226.89.127,443,tcp,tls,42064,285429,240,19306,207,304735,447,normal,-
5344174107683081035,10.0.2.16,44.235.178.34,443,tcp,tls,76455,5826,21,2921,19,8747,40,normal,-
-5514574469200678950,10.0.2.16,74.115.50.110,443,tcp,tls,5570,4113,10,1288,11,5401,21,normal,-
-7617949453763154970,10.0.2.16,142.251.37.99,443,tcp,tls,91425,5928,16,1768,16,7696,32,normal,-
-9039968988546245173,10.0.2.16,140.82.112.22,443,tcp,tls,59740,5257,17,2776,17,8033,34,normal,-
7728186308326381808,10.0.2.16,157.240.30.35,443,tcp,tls,98815,4710,16,1768,16,6478,32,normal,-
-5418665126320876830,10.0.2.16,151.101.193.16,443,tcp,tls,41283,492396,434,24591,317,516987,751,normal,-
-1382263865899328099,10.0.2.16,142.251.37.110,443,tcp,tls,90849,8435,17,1822,17,10257,34,normal,-
-1771325271016685861,10.0.2.16,142.251.36.132,443,tcp,tls,170609,6047,18,1969,19,8016,37,normal,-
-6489150694123716088,10.0.2.16,141.95.47.54,443,tcp,tls,108104,51641,105,39399,93,91040,198,normal,-
2525155966532532836,10.0.2.16,23.195.249.33,443,tcp,tls,38748,6967,21,2502,21,9469,42,normal,-
-2280898977828546065,10.0.2.16,157.240.30.18,443,tcp,tls,171172,4930,19,1915,18,6845,37,normal,-
956690482887122475,10.0.2.16,77.75.79.115,443,tcp,tls,171060,34639,43,2873,30,37512,73,normal,-
-7487385506457150212,10.0.2.16,65.9.95.76,443,tcp,tls,170828,8178,22,2463,22,10641,44,normal,-
-6646188516450994790,10.0.2.16,77.243.60.138,443,tcp,tls,10894,5009,16,2422,16,7431,32,normal,-
442093092303190287,10.0.2.16,142.251.36.67,443,tcp,tls,227,5574,11,1406,11,6980,22,normal,-
-1523334214122955833,10.0.2.16,104.19.188.97,443,tcp,tls,170972,4430,16,1807,16,6237,32,normal,-
-3915754770912011705,10.0.2.16,142.251.36.106,443,tcp,tls,581,38285,37,2384,23,40669,60,normal,-
213673370527849453,10.0.2.16,157.240.30.35,443,tcp,tls,679,6495,20,2345,20,8840,40,normal,-
370297939871899911,10.0.2.16,172.64.144.98,443,tcp,tls,16226,7022,27,10458,24,17480,51,normal,-
3432977859555315234,10.0.2.16,54.239.28.85,443,tcp,tls,5495,6583,12,1396,13,7979,25,normal,-
-4291666073606632867,10.0.2.16,13.107.42.14,443,tcp,tls,131736,13551,33,3955,31,17506,64,normal,-
-4786252822465936976,10.0.2.16,34.238.226.189,443,tcp,tls,35995,7605,17,2124,16,9729,33,normal,-
6593381216168788835,10.0.2.16,65.9.9.138,80,tcp,http,38948,1362,7,885,8,2247,15,normal,-
6464964154328503573,10.0.2.16,146.75.116.157,443,tcp,tls,178280,6020,23,2543,21,8563,44,normal,-
-1529222590206862931,10.0.2.16,34.241.134.204,443,tcp,tls,7005,12604,20,2642,17,15246,37,normal,-
5680073487519669920,10.0.2.16,52.3.74.27,443,tcp,tls,712,6479,12,1590,13,8069,25,normal,-
6204472632692269271,10.0.2.16,142.251.36.142,443,tcp,tls,346,47462,46,2777,28,50239,74,normal,-
-1648279880895667818,10.0.2.16,142.251.36.97,443,tcp,tls,611,9724,14,1568,14,11292,28,normal,-
-3654973363871978314,10.0.2.16,65.9.95.25,443,tcp,tls,543,7080,15,1568,14,8648,29,normal,-
3050273492950638294,10.0.2.16,34.248.91.210,443,tcp,tls,478,6634,14,1698,15,8332,29,normal,-
1537065353690911453,10.0.2.16,192.0.72.3,443,tcp,tls,48988,5305,15,1675,15,6980,30,normal,-
-5053924588984296830,10.0.2.16,142.251.37.106,443,tcp,tls,408,8167,20,2153,18,10320,38,normal,-
-4528848174493401205,10.0.2.16,185.58.74.239,443,tcp,tls,5603,4918,12,1388,12,6306,24,normal,-
7999995667423596911,10.0.2.16,23.195.248.26,443,tcp,tls,20301,9110,18,1745,16,10855,34,normal,-
-3685960516831365142,10.0.2.16,3.73.242.95,443,tcp,tls,2415,6526,15,2100,16,8626,31,normal,-
-2300404320736195284,10.0.2.16,52.152.143.207,443,tcp,tls,18672,8642,24,8738,24,17380,48,normal,-
6746175889711346166,10.0.2.16,142.251.36.142,443,tcp,tls,366,8162,13,1514,13,9676,26,normal,-
2314194374070085323,10.0.2.16,142.251.37.99,443,tcp,tls,272,5656,12,1460,12,7116,24,normal,-
5312476622713366603,10.0.2.16,185.89.210.212,443,tcp,tls,10760,5918,15,2305,13,8223,28,normal,-
274152944092274937,10.0.2.16,192.0.78.17,443,tcp,tls,49492,5159,13,1567,13,6726,26,normal,-
-6465165057100743684,10.0.2.16,209.54.182.161,443,tcp,tls,35357,9921,24,4237,23,14158,47,normal,-
3582773453334863390,10.0.2.16,54.200.233.147,443,tcp,tls,15419,7249,23,4882,21,12131,44,normal,-
-6256268389640640048,10.0.2.16,142.251.37.99,443,tcp,tls,141267,6053,18,1915,18,7968,36,normal,-
-6779310443843529315,10.0.2.16,23.195.248.219,443,tcp,tls,126311,3261140,2405,62683,718,3323823,3123,normal,-
-7038856246226669218,10.0.2.16,34.98.64.218,443,tcp,tls,920,5657,17,2078,16,7735,33,normal,-
-6368887093552567348,10.0.2.16,142.251.36.99,443,tcp,tls,170740,6087,18,1969,19,8056,37,normal,-
-6080048432655380613,10.0.2.16,18.215.81.116,443,tcp,tls,35108,7342,18,2208,17,9550,35,normal,-
-2902472339608278522,10.0.2.16,142.251.37.106,443,tcp,tls,127,2198,13,2202,13,4400,26,normal,-
-2725891659950406376,10.0.2.16,13.107.42.14,443,tcp,tls,130064,6989,23,2887,22,9876,45,normal,-
6846087901436685368,10.0.2.16,146.75.116.157,443,tcp,tls,136250,22255,32,2519,23,24774,55,normal,-
4247033954836942942,10.0.2.16,147.229.9.226,443,tcp,tls,3022,6398,15,2902,15,9300,30,normal,-
3983143334068941327,10.0.2.16,142.251.37.106,443,tcp,tls,156,2204,13,2146,12,4350,25,normal,-
-6526350780438925358,10.0.2.16,77.75.78.20,443,tcp,tls,170262,7224,21,2369,20,9593,41,normal,-
6507140114924903506,10.0.2.16,18.215.81.116,443,tcp,tls,721,6070,8,1023,9,7093,17,normal,-
-5176976352064761541,10.0.2.16,142.251.36.142,443,tcp,tls,297,8162,13,1514,13,9676,26,normal,-
-6926080390976974166,10.0.2.16,162.159.128.61,443,tcp,tls,5167,3435,9,1165,10,4600,19,normal,-
4677190806730383608,10.0.2.16,142.251.36.97,443,tcp,tls,612,9725,14,1568,14,11293,28,normal,-
-5955775075399043858,10.0.2.16,104.16.137.206,443,tcp,tls,171377,26968,34,2399,22,29367,56,normal,-
-321581533045425440,10.0.2.16,142.251.36.142,443,tcp,tls,67183,10587,23,2457,20,13044,43,normal,-
-6119220880020191642,10.0.2.16,142.251.37.99,443,tcp,tls,273,5710,13,1514,13,7224,26,normal,-
-5808135717498057107,10.0.2.16,77.75.79.129,443,tcp,tls,170312,7293,23,2515,22,9808,45,normal,-
-1984313625115458410,10.0.2.16,52.212.178.201,443,tcp,tls,66067,13225,28,4435,27,17660,55,normal,-
8303739927161467937,10.0.2.16,65.9.95.82,443,tcp,tls,122360,8517,23,2432,22,10949,45,normal,-
-1470231252858185403,10.0.2.16,172.64.144.98,443,tcp,tls,172,4103,11,1406,11,5509,22,normal,-
2231449795019664379,10.0.2.16,104.18.26.222,443,tcp,tls,116557,19685,32,2868,28,22553,60,normal,-
3060145337521482267,10.0.2.16,91.198.174.208,443,tcp,tls,323,5281,13,1476,12,6757,25,normal,-
3683902956545176766,10.0.2.16,205.251.242.103,443,tcp,tls,6351,6583,12,1396,13,7979,25,normal,-
-4974931074914128346,10.0.2.16,185.199.108.154,443,tcp,tls,153,4919,12,1460,12,6379,24,normal,-
-7874965452989501539,10.0.2.16,77.75.78.4,443,tcp,tls,268,6370,14,1514,13,7884,27,normal,-
3096191668290439536,10.0.2.16,157.240.221.16,443,tcp,tls,170580,4872,18,1915,18,6787,36,normal,-
5329944209229580572,10.0.2.16,89.185.235.175,443,tcp,tls,167,5913,12,1476,12,7389,24,normal,-
4639543463525033800,10.0.2.16,142.251.36.66,443,tcp,tls,1150,7838,21,2427,21,10265,42,normal,-
2889766801193175031,10.0.2.16,52.94.235.74,443,tcp,tls,39198,24825,260,343768,258,368593,518,normal,-
1485179647754499306,10.0.2.16,52.3.74.27,443,tcp,tls,727,6587,14,1698,15,8285,29,normal,-
2496621299197516041,10.0.2.16,141.95.47.56,443,tcp,tls,105178,58185,74,11044,68,69229,142,normal,-
-1788811542631057879,10.0.2.16,198.47.127.19,443,tcp,tls,35111,6187,21,2491,19,8678,40,normal,-
5742976950486110978,10.0.2.16,185.199.108.154,443,tcp,tls,60873,5545,21,2508,20,8053,41,normal,-
-8428946471557477665,10.0.2.16,142.251.36.141,443,tcp,tls,125346,6135,19,1969,19,8104,38,normal,-
8135231446418493762,10.0.2.16,77.75.77.234,443,tcp,tls,170897,8443,21,2425,21,10868,42,normal,-
-8874053802019946291,10.0.2.16,20.189.173.5,443,tcp,tls,116541,8420,25,2862,25,11282,50,normal,-
4149372302104951497,10.0.2.16,151.101.193.16,443,tcp,tls,40107,6379,13,1567,13,7946,26,normal,-
-7815469860409211783,10.0.2.16,77.75.77.195,443,tcp,tls,241593,2026138,1510,39433,624,2065571,2134,normal,-
4442895967829218554,10.0.2.16,77.75.78.30,443,tcp,tls,240404,395897,425,71590,355,467487,780,normal,-
691050253394836985,10.0.2.16,77.75.76.20,443,tcp,tls,172043,22139,36,3892,29,26031,65,normal,-
-1365259827089769330,10.0.2.16,140.82.121.6,443,tcp,tls,59486,6765,44,39375,42,46140,86,normal,-
8247171688484851958,10.0.2.16,3.89.18.11,443,tcp,tls,35975,6996,19,2229,18,9225,37,normal,-
-4190638273921275530,10.0.2.16,34.107.204.85,443,tcp,tls,323448,7977,32,4095,33,12072,65,normal,-
-5825461945047877803,10.0.2.16,77.75.76.209,443,tcp,tls,25628,64135,60,2975,33,67110,93,normal,-
-6224973241182371375,10.0.2.16,151.101.193.46,443,tcp,tls,1700,1216675,855,23408,394,1240083,1249,normal,-
-2139596542473717396,10.0.2.16,95.100.146.24,443,tcp,tls,147,6128,12,1476,12,7604,24,normal,-
-5951973383435800837,10.0.2.16,65.9.95.83,443,tcp,tls,102697,642514,479,21004,322,663518,801,normal,-
-5010668428526643559,10.0.2.16,91.198.174.208,443,tcp,tls,268,5168,11,1422,11,6590,22,normal,-
3962162997816823620,10.0.2.16,77.75.78.4,443,tcp,tls,233551,20092,41,4234,38,24326,79,normal,-
2007184328594619949,10.0.2.16,142.251.37.99,443,tcp,tls,324,78936,69,3616,37,82552,106,normal,-
933711074792606720,10.0.2.16,142.251.37.110,443,tcp,tls,66421,5858,15,1768,16,7626,31,normal,-
4904646385697933704,10.0.2.16,2.16.2.210,443,tcp,tls,642,65917,53,2514,23,68431,76,normal,-
-5569931706807909378,10.0.2.16,77.75.78.126,443,tcp,tls,171487,70225,68,3098,33,73323,101,normal,-
-7686459278005716975,10.0.2.16,34.238.226.189,443,tcp,tls,1155,6279,9,1203,10,7482,19,normal,-
-653426134939291904,10.0.2.16,52.3.74.27,443,tcp,tls,733,6641,15,1698,15,8339,30,normal,-
4477223941048982855,10.0.2.16,151.101.193.16,443,tcp,tls,216,3268,6,861,6,4129,12,normal,-
6143088319907879358,10.0.2.16,142.251.36.67,443,tcp,tls,222,5573,11,1406,11,6979,22,normal,-
8667508345095868585,10.0.2.16,142.251.36.100,443,tcp,tls,53521,5687,13,1567,13,7254,26,normal,-
-7895845877166848078,10.0.2.16,89.185.235.175,443,tcp,tls,171325,109613,94,5702,76,115315,170,normal,-
-2447351268234679550,10.0.2.16,52.94.235.74,443,tcp,tls,38657,8567,18,2962,19,11529,37,normal,-
5598029130829171608,10.0.2.16,151.101.193.46,443,tcp,tls,442,6027,11,1460,12,7487,23,normal,-
-5963843334046907203,10.0.2.16,216.239.34.36,443,tcp,tls,170550,6457,19,1969,19,8426,38,normal,-
7199933395415466605,10.0.2.16,157.240.30.3,443,tcp,tls,170423,5496,27,2248,22,7744,49,normal,-
6754658033623713110,10.0.2.16,23.195.248.244,443,tcp,tls,122075,157268,140,8384,96,165652,236,normal,-
4820206417656210766,10.0.2.16,2.16.2.194,443,tcp,tls,128633,5558539,3828,59956,1057,5618495,4885,normal,-
4295648189265736775,10.0.2.16,151.101.193.51,443,tcp,tls,37498,7372,17,2798,17,10170,34,normal,-
-917445665803122659,10.0.2.16,95.100.146.24,443,tcp,tls,146,6128,12,1476,12,7604,24,normal,-
2361767486770068666,10.0.2.16,142.251.36.142,443,tcp,tls,165,8155,13,1514,13,9669,26,normal,-
-3316366532511903241,10.0.2.16,185.199.108.154,443,tcp,tls,61007,8612,24,2839,22,11451,46,normal,-
-2604531635445849851,10.0.2.16,54.77.173.110,443,tcp,tls,35109,5672,17,2088,16,7760,33,normal,-
-1666362423457815719,10.0.2.16,95.100.146.83,443,tcp,tls,588,4058,7,969,8,5027,15,normal,-
4918883292032481603,10.0.2.16,52.94.235.74,443,tcp,tls,37100,9492,21,4859,19,14351,40,normal,-
1324255923862614426,10.0.2.16,34.107.221.82,80,tcp,http,31237,712,7,753,8,1465,15,normal,-
-2689160666144063394,10.0.2.16,142.251.36.66,443,tcp,tls,505,3088,5,861,6,3949,11,normal,-
2999089313268645926,10.0.2.16,142.251.36.131,443,tcp,tls,391,6951,16,2003,15,8954,31,normal,-
-393156502651064507,10.0.2.16,142.251.37.110,443,tcp,tls,320,24370,28,2439,20,26809,48,normal,-
-3068983098527787276,10.0.2.16,142.251.37.106,443,tcp,tls,186,2150,12,2148,12,4298,24,normal,-
-2408863651132560564,10.0.2.16,142.251.37.104,443,tcp,tls,442,113768,92,4856,68,118624,160,normal,-
4021508945117444815,10.0.2.16,52.3.74.27,443,tcp,tls,39310,23239,129,62933,127,86172,256,normal,-
-5354704188612996175,10.0.2.16,209.54.183.75,443,tcp,tls,36980,7423,16,2689,16,10112,32,normal,-
-1767873673642258270,10.0.2.16,77.75.79.195,443,tcp,tls,177326,864248,669,24107,396,888355,1065,normal,-
-8812245372639976954,10.0.2.16,147.229.9.226,443,tcp,tls,3000,20628,26,4366,25,24994,51,normal,-
-5112708226057784270,10.0.2.16,104.18.26.222,443,tcp,tls,115878,37560,45,3072,30,40632,75,normal,-
-5454972315205694451,10.0.2.16,185.199.108.154,443,tcp,tls,683,4978,12,1460,12,6438,24,normal,-
-2153142890251813428,10.0.2.16,142.251.36.106,443,tcp,tls,420,45656,44,2562,24,48218,68,normal,-
8118916377589109578,10.0.2.16,77.75.76.54,443,tcp,tls,249798,9317,37,6873,36,16190,73,normal,-
8076051649022992197,10.0.2.16,54.239.26.205,443,tcp,tls,37463,13896,23,3532,24,17428,47,normal,-
-2114759212094288251,10.0.2.16,142.251.36.138,443,tcp,tls,416,11370,16,1730,17,13100,33,normal,-
6499996140076046222,10.0.2.16,65.9.94.165,443,tcp,tls,38626,7995,19,2263,19,10258,38,normal,-
4134410736605472347,10.0.2.16,3.76.234.99,443,tcp,tls,299,5962,9,1023,9,6985,18,normal,-
3445335455313548808,10.0.2.16,13.107.238.45,443,tcp,tls,129265,9481,24,2877,23,12358,47,normal,-
-5072130617832456820,10.0.2.16,104.244.42.5,443,tcp,tls,271,3074,6,861,6,3935,12,normal,-
8156615495311423232,10.0.2.16,157.240.30.174,443,tcp,tls,902,80843,77,4451,57,85294,134,normal,-
-8936531695279880951,10.0.2.16,104.17.113.188,443,tcp,tls,30921,4204,13,1567,13,5771,26,normal,-
-5530914838158969631,10.0.2.16,74.115.50.110,443,tcp,tls,12191,11162,19,2993,16,14155,35,normal,-
-1138886034206293638,10.0.2.16,77.75.78.20,443,tcp,tls,180658,295707,295,33724,182,329431,477,normal,-
3875241901013809087,10.0.2.16,52.212.178.201,443,tcp,tls,61493,8528,20,2358,18,10886,38,normal,-
-932684526305305626,10.0.2.16,91.198.174.192,443,tcp,tls,238,5135,11,1368,10,6503,21,normal,-
2499689184537240900,10.0.2.16,77.75.78.4,443,tcp,tls,318,6424,15,1568,14,7992,29,normal,-
204250783585386919,10.0.2.16,157.240.30.3,443,tcp,tls,18011,9498,122,59211,101,68709,223,normal,-
-6397117303423884750,10.0.2.16,89.185.235.175,443,tcp,tls,391,5913,12,1476,12,7389,24,normal,-
-1320223963805462537,10.0.2.16,209.54.183.75,443,tcp,tls,37100,7423,16,2499,16,9922,32,normal,-
-3594211749324298887,10.0.2.16,77.75.78.126,443,tcp,tls,170779,70331,69,3584,41,73915,110,normal,-
-7888704738775239736,10.0.2.16,142.251.37.99,443,tcp,tls,481,68687,60,2871,31,71558,91,normal,-
7939369073672410201,10.0.2.16,91.198.174.192,443,tcp,tls,116134,393707,316,16224,190,409931,506,normal,-
3053609821796222510,10.0.2.16,77.243.60.138,443,tcp,tls,595,3502,9,969,8,4471,17,normal,-
-2098794846115959184,10.0.2.16,146.59.30.104,443,tcp,tls,101286,10454,25,2683,23,13137,48,normal,-
5327483730261328725,10.0.2.16,65.9.95.38,443,tcp,tls,37842,16470,29,5401,28,21871,57,normal,-
-8765177695538573920,10.0.2.16,142.251.36.100,443,tcp,tls,256,5621,12,1460,12,7081,24,normal,-
-6640816002991471567,10.0.2.16,151.101.193.16,443,tcp,tls,201,3268,6,861,6,4129,12,normal,-
-3026952002150108992,10.0.2.16,77.75.78.104,443,tcp,tls,10292,9063,16,3135,16,12198,32,normal,-
3401423804278018561,10.0.2.16,77.75.79.195,443,tcp,tls,254956,5238808,4005,93065,1366,5331873,5371,normal,-
-4991650618087471018,10.0.2.16,141.95.47.54,443,tcp,tls,450,4503,14,1536,12,6039,26,normal,-
-3463243659030570870,10.0.2.16,142.251.36.142,443,tcp,tls,364,8163,13,1514,13,9677,26,normal,-
8665222791157330522,10.0.2.16,141.95.47.54,443,tcp,tls,101117,55725,58,3930,45,59655,103,normal,-
-9148514076916237790,10.0.2.16,209.54.182.161,443,tcp,tls,5689,6691,12,1396,13,8087,25,normal,-
8715745355374089206,10.0.2.16,151.101.193.16,443,tcp,tls,339,6403,13,1514,13,7917,26,normal,-
8808373483289300938,10.0.2.16,157.240.30.35,443,tcp,tls,170973,4983,20,1915,18,6898,38,normal,-
-4845301852806322213,10.0.2.16,52.97.189.66,443,tcp,tls,49339,5911,15,1691,15,7602,30,normal,-
4318806567166510603,10.0.2.16,104.19.187.97,443,tcp,tls,19148,142936,112,4856,62,147792,174,normal,-
4248806075831663638,10.0.2.16,142.251.36.97,443,tcp,tls,451,9717,14,1568,14,11285,28,normal,-
1552598244643901489,10.0.2.16,65.9.94.19,443,tcp,tls,38265,7917,18,2209,18,10126,36,normal,-
2867442420140209928,10.0.2.16,157.240.30.35,443,tcp,tls,429,3841,7,969,8,4810,15,normal,-
8333842537132030395,10.0.2.16,52.3.74.27,443,tcp,tls,733,6587,14,1590,13,8177,27,normal,-
7806222962190544765,10.0.2.16,77.75.79.69,443,tcp,tls,170398,7120,22,3028,22,10148,44,normal,-
-8066719561811811457,10.0.2.16,18.192.113.106,443,tcp,tls,730,6320,13,1365,13,7685,26,normal,-
-6716326846918724949,10.0.2.16,104.17.112.188,443,tcp,tls,30431,4212,13,1567,13,5779,26,normal,-
217947021163890686,10.0.2.16,104.16.57.101,443,tcp,tls,170578,4512,17,1861,17,6373,34,normal,-
-4817795939636517742,10.0.2.16,141.226.228.48,443,tcp,tls,34979,5433,15,1947,14,7380,29,normal,-
-1996408821469753209,10.0.2.16,65.9.95.25,443,tcp,tls,307,7080,15,1568,14,8648,29,normal,-
7094360513100463749,10.0.2.16,146.59.30.100,443,tcp,tls,101230,10523,26,2559,21,13082,47,normal,-
-2613862027154188304,10.0.2.16,52.94.235.74,443,tcp,tls,410,6750,10,1257,11,8007,21,normal,-
3520891359332328605,10.0.2.16,142.251.37.99,443,tcp,tls,271,5655,12,1460,12,7115,24,normal,-
7771756940149965978,10.0.2.16,151.101.193.46,443,tcp,tls,582,6147,13,1514,13,7661,26,normal,-
8702016319487794087,10.0.2.16,65.9.95.127,443,tcp,tls,99876,7642,18,1876,18,9518,36,normal,-
-7520832645951556559,10.0.2.16,54.239.26.205,443,tcp,tls,37531,7648,17,2462,17,10110,34,normal,-
-3120524333673639765,10.0.2.16,77.75.77.195,443,tcp,tls,161,6521,13,1530,13,8051,26,normal,-
7552550942390336112,10.0.2.16,77.75.77.195,443,tcp,tls,171008,23743,32,2712,26,26455,58,normal,-
4720257322026774134,10.0.2.16,23.195.249.173,443,tcp,tls,206,7474,13,1530,13,9004,26,normal,-
-4799099322754700169,10.0.2.16,77.75.77.195,443,tcp,tls,232,6505,13,1530,13,8035,26,normal,-
-34620541986039516,10.0.2.16,77.75.78.36,443,tcp,tls,172060,8385,30,3623,28,12008,58,normal,-
-4308282653460138701,10.0.2.16,13.107.21.200,443,tcp,tls,234,8397,16,1676,14,10073,30,normal,-
-2995154215826361246,10.0.2.16,142.251.36.132,443,tcp,tls,96885,3559,19,2494,19,6053,38,normal,-
126499675046250594,10.0.2.16,185.66.189.42,443,tcp,tls,122168,21645,34,3815,26,25460,60,normal,-
-474711751301937608,10.0.2.16,109.123.210.246,443,tcp,tls,171094,13476,26,4253,27,17729,53,normal,-
-4520335444047183497,10.0.2.16,77.75.76.104,443,tcp,tls,130008,14851,35,4164,27,19015,62,normal,-
-5949075603792279737,10.0.2.16,172.64.144.98,443,tcp,tls,19632,4677,15,1981,15,6658,30,normal,-
-7664234642757613262,10.0.2.16,142.251.36.142,443,tcp,tls,364,8162,13,1514,13,9676,26,normal,-
-8711917120810130215,10.0.2.16,37.157.5.141,443,tcp,tls,372,1642,4,807,5,2449,9,normal,-
3449108555534250469,10.0.2.16,141.226.228.48,443,tcp,tls,396,3268,6,861,6,4129,12,normal,-
-4590087234916740059,10.0.2.16,185.89.210.212,443,tcp,tls,569,1522,4,807,5,2329,9,normal,-
6595518318358122844,10.0.2.16,77.75.77.195,443,tcp,tls,214021,2453053,1823,36414,605,2489467,2428,normal,-
4657835825472955312,10.0.2.16,104.208.16.89,443,tcp,tls,133197,8565,27,7689,26,16254,53,normal,-
1143129352959441615,10.0.2.16,77.75.76.104,443,tcp,tls,115804,28640,41,3205,39,31845,80,normal,-
-6597570958271981760,10.0.2.16,18.192.113.106,443,tcp,tls,35107,7490,18,2433,17,9923,35,normal,-
-1051367353125256994,10.0.2.16,54.204.217.253,443,tcp,tls,9699,8311,27,10189,26,18500,53,normal,-
-1638168357708837011,10.0.2.16,142.251.36.142,443,tcp,tls,360,8155,13,1514,13,9669,26,normal,-
-1560913545707208069,10.0.2.16,3.120.0.25,443,tcp,tls,1067,6391,13,1365,13,7756,26,normal,-
7056935948131422319,10.0.2.16,104.18.25.196,443,tcp,tls,170343,4519,17,1861,17,6380,34,normal,-
-867831971277474848,10.0.2.16,45.79.188.190,443,tcp,tls,36566,7691,16,2058,16,9749,32,normal,-
3616245447412160660,10.0.2.16,52.94.235.74,443,tcp,tls,5551,6870,12,1396,13,8266,25,normal,-
3893710502312809518,10.0.2.16,104.19.188.97,443,tcp,tls,171091,4407,16,1807,16,6214,32,normal,-
7795157019399302949,10.0.2.16,142.251.36.141,443,tcp,tls,171055,6081,18,1969,19,8050,37,normal,-
-9017361760116592312,10.0.2.16,185.199.108.154,443,tcp,tls,383,4834,10,1406,11,6240,21,normal,-
7850747356131424712,10.0.2.16,172.67.4.41,443,tcp,tls,13737,10230,19,2244,19,12474,38,normal,-
352600495381257008,10.0.2.16,142.251.37.99,443,tcp,tls,20257,392932,287,9342,142,402274,429,normal,-
1114379993746377062,10.0.2.16,23.195.248.26,443,tcp,tls,20278,9110,18,1691,15,10801,33,normal,-
-299995994857391627,10.0.2.16,185.199.108.154,443,tcp,tls,206,4834,10,1406,11,6240,21,normal,-
9187400007509385653,10.0.2.16,2.16.2.210,443,tcp,tls,665,62993,51,2622,25,65615,76,normal,-
4465274445917220252,10.0.2.16,142.251.37.99,443,tcp,tls,101984,47116,50,3334,32,50450,82,normal,-
-3615305278365740824,10.0.2.16,209.54.182.161,443,tcp,tls,5758,6691,12,1396,13,8087,25,normal,-
8797650918100604937,10.0.2.16,104.19.187.97,443,tcp,tls,19897,55193,54,3511,35,58704,89,normal,-
6943880249456336089,10.0.2.16,40.126.31.67,443,tcp,tls,116462,12574,27,2638,24,15212,51,normal,-
-1513810704018175031,10.0.2.16,142.251.37.106,443,tcp,tls,128,2198,13,2201,13,4399,26,normal,-
-7979912163138744345,10.0.2.16,77.75.78.101,443,tcp,tls,172123,8124,29,3018,28,11142,57,normal,-
3021215754184711212,10.0.2.16,65.9.95.48,443,tcp,tls,99874,7642,18,1876,18,9518,36,normal,-
8015926339339656445,10.0.2.16,65.9.95.83,443,tcp,tls,161,6960,13,1514,13,8474,26,normal,-
7451659721114877551,10.0.2.16,91.198.174.192,443,tcp,tls,144,3268,6,861,6,4129,12,normal,-
-1604708539900962306,10.0.2.16,52.94.235.74,443,tcp,tls,37704,10257,26,9267,26,19524,52,normal,-
2595958341331405073,10.0.2.16,77.75.76.104,443,tcp,tls,75535,14581,31,3579,26,18160,57,normal,-
4199313114833312054,10.0.2.16,68.219.88.97,443,tcp,tls,121493,8436,22,4153,20,12589,42,normal,-
2541487555780648,10.0.2.16,2.16.2.193,443,tcp,tls,5426,4598,12,1342,12,5940,24,normal,-
-729645828442241304,10.0.2.16,142.251.36.106,443,tcp,tls,193,2204,13,2202,13,4406,26,normal,-
-9199391168933957847,10.0.2.16,91.198.174.192,443,tcp,tls,148639,11257,25,2706,24,13963,49,normal,-
-7337842261315434639,10.0.2.16,172.67.28.68,443,tcp,tls,450,28223,31,2525,26,30748,57,normal,-
-8849911832237851779,10.0.2.16,151.101.193.46,443,tcp,tls,622,6147,13,1514,13,7661,26,normal,-
-7592020669160415108,10.0.2.16,77.75.79.232,443,tcp,tls,171156,7867,27,4592,26,12459,53,normal,-
1406661554187640998,10.0.2.16,13.107.21.200,443,tcp,tls,16030,21704,29,2894,29,24598,58,normal,-
-5147881456263983801,10.0.2.16,157.240.30.63,443,tcp,tls,184,4234,13,1460,12,5694,25,normal,-
2600956412984736246,10.0.2.16,151.101.193.111,443,tcp,tls,12506,12195,19,2080,17,14275,36,normal,-
7669245424594222352,10.0.2.16,209.54.182.161,443,tcp,tls,34460,7493,17,2081,17,9574,34,normal,-
-664358458582574678,10.0.2.16,65.9.95.29,443,tcp,tls,15800,67345,59,3072,36,70417,95,normal,-
-3492372938011717127,10.0.2.16,77.75.76.36,443,tcp,tls,180104,10331,34,6584,34,16915,68,normal,-
-7677135913393007844,10.0.2.16,87.240.132.78,443,tcp,tls,60148,5811,17,1838,17,7649,34,normal,-
-7669611140462068046,10.0.2.16,54.155.194.178,443,tcp,tls,35695,7169,20,2688,18,9857,38,normal,-
-4727957151935783749,10.0.2.16,77.75.77.234,443,tcp,tls,248380,35860,46,5202,39,41062,85,normal,-
-9211399318810252690,10.0.2.16,142.251.36.131,443,tcp,tls,152,5595,11,1406,11,7001,22,normal,-
-687910995294584595,10.0.2.16,142.250.27.156,443,tcp,tls,171140,6296,18,1969,19,8265,37,normal,-
3955512472092977544,10.0.2.16,44.235.178.34,443,tcp,tls,1274,4478,13,1503,12,5981,25,normal,-
3211301869214389249,10.0.2.16,65.9.99.119,443,tcp,tls,15705,8219,15,1823,15,10042,30,normal,-
7088895215068277271,10.0.2.16,77.75.77.195,443,tcp,tls,202,6436,12,1476,12,7912,24,normal,-
6831174549582301407,10.0.2.16,142.251.36.106,443,tcp,tls,134,2252,14,2201,13,4453,27,normal,-
-9067615630353824690,10.0.2.16,142.251.37.110,443,tcp,tls,471,7504,18,2518,17,10022,35,normal,-
-420311981585821375,10.0.2.16,77.75.79.15,443,tcp,tls,171081,6098,19,2360,20,8458,39,normal,-
4819385645859219492,10.0.2.16,209.54.182.161,443,tcp,tls,5454,25698,44,10405,37,36103,81,normal,-
4578204763739574288,10.0.2.16,52.41.225.242,443,tcp,tls,141300,7043,21,2447,19,9490,40,normal,-
1284110774440483110,10.0.2.16,151.101.193.16,443,tcp,tls,290,6328,13,1514,13,7842,26,normal,-
-627659049318103255,10.0.2.16,151.101.193.21,443,tcp,tls,48656,9047,19,2283,18,11330,37,normal,-
612377976821012483,10.0.2.16,151.101.194.110,443,tcp,tls,170710,6729,22,2409,20,9138,42,normal,-
-7679194990714151976,10.0.2.16,52.223.198.20,443,tcp,tls,4361,18283,22,3301,22,21584,44,normal,-
-70818098624528915,10.0.2.16,23.195.248.26,443,tcp,tls,244,9050,17,1692,16,10742,33,normal,-
-5609608794505362313,10.0.2.16,52.94.235.74,443,tcp,tls,36759,9534,23,6823,22,16357,45,normal,-
3784863610553969896,10.0.2.16,77.75.76.101,443,tcp,tls,170372,7579,24,2550,22,10129,46,normal,-
-917859225778458456,10.0.2.16,2.16.2.192,443,tcp,tls,120397,11248,24,2308,20,13556,44,normal,-
3980571150566288625,10.0.2.16,142.251.36.100,443,tcp,tls,432,8248,18,2139,16,10387,34,normal,-
1511130326421251604,10.0.2.16,185.199.108.154,443,tcp,tls,443,4919,12,1460,12,6379,24,normal,-
6308603879541490730,10.0.2.16,77.75.78.229,443,tcp,tls,216778,9985,40,7059,37,17044,77,normal,-
-3180408315884171966,10.0.2.16,151.101.193.140,443,tcp,tls,170714,6163,20,2382,21,8545,41,normal,-
4941910864325194363,10.0.2.16,104.22.7.216,443,tcp,tls,198,4088,11,1406,11,5494,22,normal,-
-8559721945062124516,10.0.2.16,34.231.64.174,443,tcp,tls,144241,7002,21,2181,21,9183,42,normal,-
-8469219325998958518,10.0.2.16,184.72.105.205,443,tcp,tls,5893,6537,14,1450,14,7987,28,normal,-
-2654499888830253218,10.0.2.16,142.251.36.141,443,tcp,tls,302,7661,19,3872,17,11533,36,normal,-
-2193409501315370218,10.0.2.16,142.251.37.110,443,tcp,tls,171019,8588,19,1861,17,10449,36,normal,-
4090413730150082782,10.0.2.16,142.251.37.104,443,tcp,tls,356,55890,51,2857,31,58747,82,normal,-
-517847106219241663,10.0.2.16,212.82.100.182,443,tcp,tls,35483,6314,16,1957,14,8271,30,normal,-
-6695664693224233480,10.0.2.16,186.192.81.5,443,tcp,tls,66272,5573,15,1784,16,7357,31,normal,-
8987826148182666830,10.0.2.16,142.251.36.86,443,tcp,tls,171145,6566,19,2023,20,8589,39,normal,-
3042109090569420356,10.0.2.16,142.251.36.97,443,tcp,tls,462,9719,14,1568,14,11287,28,normal,-
-8239804959894171694,10.0.2.16,142.251.36.110,443,tcp,tls,849,890282,629,17821,294,908103,923,normal,-
1670259303620780183,10.0.2.16,23.195.248.208,443,tcp,tls,123650,12195,28,2979,22,15174,50,normal,-
1624659387170918047,10.0.2.16,52.94.235.74,443,tcp,tls,38789,9553,25,11885,26,21438,51,normal,-
-916914517550073131,10.0.2.16,65.9.94.112,443,tcp,tls,37924,7680,17,2205,17,9885,34,normal,-
3522150330860986461,10.0.2.16,142.251.36.97,443,tcp,tls,525,9723,14,1568,14,11291,28,normal,-
3365169985199887808,10.0.2.16,91.198.174.192,443,tcp,tls,216,5190,12,1422,11,6612,23,normal,-
-7815200422510801998,10.0.2.16,3.71.149.231,443,tcp,tls,34030,6456,19,2325,19,8781,38,normal,-
3003455087912373319,10.0.2.16,157.240.30.27,443,tcp,tls,216,7300,17,1935,15,9235,32,normal,-
-5866466112007420761,10.0.2.16,104.19.154.83,443,tcp,tls,170823,4503,17,1861,17,6364,34,normal,-
-4123481050422684479,10.0.2.16,77.75.79.232,443,tcp,tls,170390,7731,26,4778,25,12509,51,normal,-
-6680774215303618431,10.0.2.16,142.251.37.106,443,tcp,tls,188,2150,12,2148,12,4298,24,normal,-
6455914674746893722,10.0.2.16,85.239.227.134,443,tcp,tls,170343,8039,21,2399,20,10438,41,normal,-
7186982860094501467,10.0.2.16,151.101.1.111,443,tcp,tls,12509,6904,13,1583,13,8487,26,normal,-
7463066580168476108,10.0.2.16,65.9.95.25,443,tcp,tls,102196,300413,226,12402,195,312815,421,normal,-
-1899692204137801339,10.0.2.16,192.229.221.25,443,tcp,tls,47696,8120,19,1799,17,9919,36,normal,-
-187140979116619794,10.0.2.16,142.251.37.106,443,tcp,tls,508,8021,18,2118,17,10139,35,normal,-
3402602548017831623,10.0.2.16,77.75.78.157,443,tcp,tls,175572,8859,29,3169,27,12028,56,normal,-
9150729916097340977,10.0.2.16,52.94.235.74,443,tcp,tls,39110,7965,20,6884,21,14849,41,normal,-
-5380889159507809858,10.0.2.16,157.240.30.27,443,tcp,tls,50093,98069,82,3391,41,101460,123,normal,-
2743843779136589902,10.0.2.16,13.107.21.200,443,tcp,tls,217,8223,13,1622,13,9845,26,normal,-
3833518310607265714,10.0.2.16,142.251.36.98,443,tcp,tls,141479,6351,19,1969,19,8320,38,normal,-
2456916052161757008,10.0.2.16,142.251.37.110,443,tcp,tls,286,8162,13,1514,13,9676,26,normal,-
685557822361094837,10.0.2.16,157.240.30.35,443,tcp,tls,479,6970,21,2470,17,9440,38,normal,-
-1213455001844850918,10.0.2.16,142.251.36.106,443,tcp,tls,119,2534,13,2201,13,4735,26,normal,-
1904244976332744802,10.0.2.16,157.240.30.63,443,tcp,tls,182,4119,11,1352,10,5471,21,normal,-
-4981370697344475047,10.0.2.16,157.240.30.63,443,tcp,tls,183,4175,12,1406,11,5581,23,normal,-
81958460376505519,10.0.2.16,91.198.174.192,443,tcp,tls,268,5136,11,1368,10,6504,21,normal,-
25610890002049493,10.0.2.16,152.199.19.161,443,tcp,tls,136500,22275,32,2561,24,24836,56,normal,-
1703886784372262520,10.0.2.16,23.195.249.173,443,tcp,tls,130948,332256,272,28646,256,360902,528,normal,-
-423872410231285758,10.0.2.16,185.66.189.42,443,tcp,tls,233,6275,12,1460,12,7735,24,normal,-
-1776625826979779420,10.0.2.16,65.9.95.81,443,tcp,tls,558,6028,7,969,8,6997,15,normal,-
5903533161377628922,10.0.2.16,142.251.36.142,443,tcp,tls,487,8161,13,1514,13,9675,26,normal,-
6710294145953758713,10.0.2.16,104.18.26.222,443,tcp,tls,115879,26941,38,3018,29,29959,67,normal,-
-7818284126332419848,10.0.2.16,8.8.8.8,53,udp,dns,103,148,1,92,1,240,2,normal,-
6904192550770179674,10.0.2.16,8.8.8.8,53,udp,dns,64,295,1,94,1,389,2,normal,-
2490807759702726392,10.0.2.16,151.101.193.16,443,tcp,-,89,60,1,128,2,188,3,normal,-
-3571493554385994685,10.0.2.16,8.8.8.8,53,udp,dns,165,339,2,193,2,532,4,normal,-
1455849762171802756,10.0.2.16,8.8.8.8,53,udp,dns,1335,255,2,176,2,431,4,normal,-
8527646421507341145,10.0.2.16,8.8.8.8,53,udp,dns,44,207,1,114,1,321,2,normal,-
-3071836417305217461,10.0.2.16,8.8.8.8,53,udp,dns,47,134,1,89,1,223,2,normal,-
-221827744986258585,10.0.2.16,104.19.154.83,443,udp,-,268,7748,13,2367,7,10115,20,normal,-
6925353392745048908,10.0.2.16,8.8.8.8,53,udp,dns,68,96,1,80,1,176,2,normal,-
7068138764000668554,10.0.2.16,8.8.8.8,53,udp,dns,40,233,1,101,1,334,2,normal,-
-5612782810435407784,10.0.2.16,8.8.8.8,53,udp,dns,44,146,1,81,1,227,2,normal,-
-2728526530458564467,10.0.2.16,8.8.8.8,53,udp,dns,49,175,1,79,1,254,2,normal,-
-6314291957154943839,10.0.2.16,8.8.8.8,53,udp,dns,109,123,1,95,1,218,2,normal,-
930877917153474313,10.0.2.16,8.8.8.8,53,udp,dns,57,113,1,97,1,210,2,normal,-
-1064380312328470999,10.0.2.16,8.8.8.8,53,udp,dns,126,132,1,116,1,248,2,normal,-
-880962893114235891,10.0.2.16,8.8.8.8,53,udp,dns,56,180,1,118,1,298,2,normal,-
-7499236698821187591,10.0.2.16,8.8.8.8,53,udp,dns,37,207,1,114,1,321,2,normal,-
-190628592952274548,10.0.2.16,8.8.8.8,53,udp,dns,47,156,1,91,1,247,2,normal,-
1285033998469718864,10.0.2.16,8.8.8.8,53,udp,dns,41,95,1,79,1,174,2,normal,-
-4608799202077167936,10.0.2.16,8.8.8.8,53,udp,dns,45,102,1,86,1,188,2,normal,-
5739939894894902022,10.0.2.16,142.251.36.131,443,udp,-,212,7022,8,1983,7,9005,15,normal,-
7199396701500501972,10.0.2.16,8.8.8.8,53,udp,dns,56,101,1,85,1,186,2,normal,-
9010349866005325382,10.0.2.16,8.8.8.8,53,udp,dns,113,198,1,86,1,284,2,normal,-
-3287487021863722881,10.0.2.16,8.8.8.8,53,udp,dns,52,141,1,85,1,226,2,normal,-
4392347505148194242,10.0.2.16,8.8.8.8,53,udp,dns,79,101,1,85,1,186,2,normal,-
6569277274856226557,10.0.2.16,142.251.36.100,443,udp,-,7253,35114,44,4905,20,40019,64,normal,-
-2114874738162054942,10.0.2.16,8.8.8.8,53,udp,dns,46,133,1,84,1,217,2,normal,-
4842154899692705431,10.0.2.16,157.240.221.16,443,udp,-,242,7494,12,2491,8,9985,20,normal,-
-1333598100979935786,10.0.2.16,8.8.8.8,53,udp,dns,125,121,1,85,1,206,2,normal,-
3672370429312226198,10.0.2.16,8.8.8.8,53,udp,dns,90,146,1,81,1,227,2,normal,-
4562111020248147652,10.0.2.16,8.8.8.8,53,udp,dns,48,132,1,83,1,215,2,normal,-
-7570248783093352509,10.0.2.16,8.8.8.8,53,udp,dns,78174,256,2,170,2,426,4,normal,-
8925748774609909917,10.0.2.16,8.8.8.8,53,udp,dns,61,184,1,99,1,283,2,normal,-
2239716747960449975,10.0.2.16,142.251.36.106,443,udp,-,179,7370,8,1987,7,9357,15,normal,-
4368336596300682211,10.0.2.16,8.8.8.8,53,udp,dns,36,156,1,83,1,239,2,normal,-
5667627490581223942,10.0.2.16,8.8.8.8,53,udp,dns,52,91,1,75,1,166,2,normal,-
-2383477352731303777,10.0.2.16,8.8.8.8,53,udp,dns,113,137,1,81,1,218,2,normal,-
3525982895997754299,10.0.2.16,8.8.8.8,53,udp,dns,111,112,1,84,1,196,2,normal,-
-1174543305655076208,10.0.2.16,8.8.8.8,53,udp,dns,61,208,1,87,1,295,2,normal,-
2036880344752245412,10.0.2.16,8.8.8.8,53,udp,dns,32,115,1,99,1,214,2,normal,-
8806362156790247564,10.0.2.16,8.8.8.8,53,udp,dns,38,184,1,86,1,270,2,normal,-
-8535331573368708642,10.0.2.16,8.8.8.8,53,udp,dns,90,141,1,82,1,223,2,normal,-
-7358903183317422227,10.0.2.16,8.8.8.8,53,udp,dns,89,135,1,84,1,219,2,normal,-
-4557623406899408622,10.0.2.16,8.8.8.8,53,udp,dns,117,187,1,100,1,287,2,normal,-
9043269526797335571,10.0.2.16,91.80.50.145,443,udp,-,225,5250,8,1911,6,7161,14,normal,-
-4667064821686496425,10.0.2.16,192.229.221.95,80,tcp,http,35624,2190,10,1466,11,3656,21,normal,-
-1765121808322288982,10.0.2.16,8.8.8.8,53,udp,dns,42,130,1,114,1,244,2,normal,-
1220028050073090076,10.0.2.16,8.8.8.8,53,udp,dns,45,107,1,91,1,198,2,normal,-
4980222819218941849,10.0.2.16,8.8.8.8,53,udp,dns,50,158,1,87,1,245,2,normal,-
-6887180647226544603,10.0.2.16,157.240.30.27,443,udp,-,291,122368,103,4406,36,126774,139,normal,-
7322742425071498275,10.0.2.16,8.8.8.8,53,udp,dns,42,188,1,82,1,270,2,normal,-
-1978943205921820601,10.0.2.16,8.8.8.8,53,udp,dns,55,213,1,87,1,300,2,normal,-
5892357796923860519,10.0.2.16,8.8.8.8,53,udp,dns,65,161,1,103,1,264,2,normal,-
-695067507052842004,10.0.2.16,8.8.8.8,53,udp,dns,89,195,1,84,1,279,2,normal,-
-4967182718190528725,10.0.2.16,142.251.36.78,443,udp,-,16770,316296,335,78319,198,394615,533,normal,-
6690908224842179684,10.0.2.16,8.8.8.8,53,udp,dns,37,170,1,88,1,258,2,normal,-
8097499549664235967,10.0.2.16,8.8.8.8,53,udp,dns,54,118,1,86,1,204,2,normal,-
-2743568625034033709,10.0.2.16,8.8.8.8,53,udp,dns,38,120,1,88,1,208,2,normal,-
-3633309215969955163,10.0.2.16,8.8.8.8,53,udp,dns,47,173,1,92,1,265,2,normal,-
1338163107232153827,10.0.2.16,8.8.8.8,53,udp,dns,55,135,1,84,1,219,2,normal,-
6188591424605837517,10.0.2.16,8.8.8.8,53,udp,dns,52,131,1,82,1,213,2,normal,-
-2687220859441130164,10.0.2.16,8.8.8.8,53,udp,dns,73,164,1,85,1,249,2,normal,-
-2026457540417021001,10.0.2.16,8.8.8.8,53,udp,dns,81,170,1,88,1,258,2,normal,-
-3539845322648426407,10.0.2.16,8.8.8.8,53,udp,dns,52,124,1,108,1,232,2,normal,-
-3732920816482269294,10.0.2.16,142.251.37.110,443,udp,-,216,9827,12,2674,13,12501,25,normal,-
-5817444221122606173,10.0.2.16,8.8.8.8,53,udp,dns,69,216,1,132,1,348,2,normal,-
-8502858086472680320,10.0.2.16,31.30.189.145,443,udp,-,148,5323,9,2174,8,7497,17,normal,-
-1445751253430291319,10.0.2.16,8.8.8.8,53,udp,dns,34,108,1,92,1,200,2,normal,-
7308700419082020659,10.0.2.16,8.8.8.8,53,udp,dns,48,132,1,83,1,215,2,normal,-
8785716783049381745,10.0.2.16,8.8.8.8,53,udp,dns,55,157,1,103,1,260,2,normal,-
-4324716736167769251,10.0.2.16,8.8.8.8,53,udp,dns,50,114,1,86,1,200,2,normal,-
8970433644859385860,10.0.2.16,8.8.8.8,53,udp,dns,38,143,1,87,1,230,2,normal,-
1365844093800210476,10.0.2.16,8.8.8.8,53,udp,dns,75,211,1,83,1,294,2,normal,-
-6223842933651346461,10.0.2.16,8.8.8.8,53,udp,dns,66,111,1,83,1,194,2,normal,-
-221084493211936610,10.0.2.16,142.251.36.67,443,udp,-,179,7001,8,2069,8,9070,16,normal,-
8011008463699024971,10.0.2.16,8.8.8.8,53,udp,dns,48,126,1,98,1,224,2,normal,-
-1619819773312819867,10.0.2.16,8.8.8.8,53,udp,dns,59,117,1,85,1,202,2,normal,-
-1624640246329398420,10.0.2.16,8.8.8.8,53,udp,dns,55,141,1,93,1,234,2,normal,-
-3429831376621556270,10.0.2.16,8.8.8.8,53,udp,dns,62,239,1,91,1,330,2,normal,-
-7829184650751610072,10.0.2.16,8.8.8.8,53,udp,dns,46,181,1,97,1,278,2,normal,-
-8242737802931762344,10.0.2.16,8.8.8.8,53,udp,dns,44,141,1,82,1,223,2,normal,-
6277017491742190299,10.0.2.16,142.251.37.99,443,udp,-,4013,441935,370,25507,144,467442,514,normal,-
-5062068705001092400,10.0.2.16,8.8.8.8,53,udp,dns,70,161,1,84,1,245,2,normal,-
-615725813651633268,10.0.2.16,8.8.8.8,53,udp,dns,95,185,1,84,1,269,2,normal,-
6780026247450885170,10.0.2.16,8.8.8.8,53,udp,dns,63,148,1,92,1,240,2,normal,-
2168916500019229386,10.0.2.16,8.8.8.8,53,udp,dns,49,121,1,93,1,214,2,normal,-
-5501792549193534046,10.0.2.16,8.8.8.8,53,udp,dns,59,179,1,114,1,293,2,normal,-
2471023883958414099,10.0.2.16,65.9.9.138,80,tcp,http,39844,2604,10,1480,11,4084,21,normal,-
5153382089901055389,10.0.2.16,8.8.8.8,53,udp,dns,42,125,1,85,1,210,2,normal,-
1296231616677769358,10.0.2.16,8.8.8.8,53,udp,dns,78,156,1,83,1,239,2,normal,-
-8290336210232267304,10.0.2.16,8.8.8.8,53,udp,dns,86,207,1,114,1,321,2,normal,-
-6486808851949988723,10.0.2.16,8.8.8.8,53,udp,dns,66,170,1,88,1,258,2,normal,-
4747844744637559704,10.0.2.16,8.8.8.8,53,udp,dns,42,170,1,88,1,258,2,normal,-
6718861224282173376,10.0.2.16,142.251.37.110,443,udp,-,244,10471,11,2444,11,12915,22,normal,-
5501741495667091243,10.0.2.16,157.240.30.35,443,udp,-,107,2293,7,1678,4,3971,11,normal,-
-2000476225425573214,10.0.2.16,8.8.8.8,53,udp,dns,93,117,1,89,1,206,2,normal,-
3705265961166677555,10.0.2.16,8.8.8.8,53,udp,dns,87,172,1,92,1,264,2,normal,-
-3481860063543285784,10.0.2.16,8.8.8.8,53,udp,dns,59,135,1,84,1,219,2,normal,-
-2729175121645990415,10.0.2.16,8.8.8.8,53,udp,dns,144,149,1,84,1,233,2,normal,-
-2849591216417307468,10.0.2.16,8.8.8.8,53,udp,dns,58,152,1,96,1,248,2,normal,-
2553394168672420504,10.0.2.16,8.8.8.8,53,udp,dns,40,114,1,86,1,200,2,normal,-
3882565633792122545,10.0.2.16,8.8.8.8,53,udp,dns,50,255,1,88,1,343,2,normal,-
3510680143409295997,10.0.2.16,8.8.8.8,53,udp,dns,54,160,1,83,1,243,2,normal,-
-64948902746444814,10.0.2.16,8.8.8.8,53,udp,dns,40,132,1,83,1,215,2,normal,-
3769686955956604309,10.0.2.16,8.8.8.8,53,udp,dns,45,307,1,101,1,408,2,normal,-
8583917935147274013,10.0.2.16,8.8.8.8,53,udp,dns,58,190,1,90,1,280,2,normal,-
2716736244216789162,10.0.2.16,8.8.8.8,53,udp,dns,47,216,1,96,1,312,2,normal,-
-6032770530087398619,10.0.2.16,8.8.8.8,53,udp,dns,137,115,1,99,1,214,2,normal,-
-1262686181261725661,10.0.2.16,8.8.8.8,53,udp,dns,46,123,1,88,1,211,2,normal,-
-7163850070564612221,10.0.2.16,8.8.8.8,53,udp,dns,48,156,1,83,1,239,2,normal,-
558874537653626914,10.0.2.16,8.8.8.8,53,udp,dns,62,207,1,114,1,321,2,normal,-
638183982162573222,10.0.2.16,8.8.8.8,53,udp,dns,53,205,1,90,1,295,2,normal,-
6180789561979947153,10.0.2.16,8.8.8.8,53,udp,dns,141,143,1,87,1,230,2,normal,-
2522246481633152976,10.0.2.16,8.8.8.8,53,udp,dns,48,164,1,100,1,264,2,normal,-
-5433533844616460602,10.0.2.16,8.8.8.8,53,udp,dns,163,105,1,89,1,194,2,normal,-
-6372440559689020913,10.0.2.16,8.8.8.8,53,udp,dns,42,214,1,85,1,299,2,normal,-
1464809468918765191,10.0.2.16,8.8.8.8,53,udp,dns,48,156,1,92,1,248,2,normal,-
-3046569591302836647,10.0.2.16,8.8.8.8,53,udp,dns,55,126,1,98,1,224,2,normal,-
-3016426270930529196,10.0.2.16,8.8.8.8,53,udp,dns,139,157,1,84,1,241,2,normal,-
-6822218251857039875,10.0.2.16,8.8.8.8,53,udp,dns,41,170,1,88,1,258,2,normal,-
9010025570411612408,10.0.2.16,8.8.8.8,53,udp,dns,74,114,1,86,1,200,2,normal,-
-2152665826773107961,10.0.2.16,8.8.8.8,53,udp,dns,136,189,1,118,1,307,2,normal,-
6223844246025512853,10.0.2.16,8.8.8.8,53,udp,dns,53,102,1,86,1,188,2,normal,-
-1996314220044713550,10.0.2.16,8.8.8.8,53,udp,dns,58,187,1,116,1,303,2,normal,-
-6524155417216089076,10.0.2.16,8.8.8.8,53,udp,dns,127,100,1,84,1,184,2,normal,-
-7575760642201561646,10.0.2.16,142.251.36.142,443,udp,-,11242,966195,823,135625,351,1101820,1174,normal,-
-5282002710904644744,10.0.2.16,8.8.8.8,53,udp,dns,63,357,1,89,1,446,2,normal,-
-7685307333176559380,10.0.2.16,8.8.8.8,53,udp,dns,50,217,1,90,1,307,2,normal,-
975999694520527092,10.0.2.16,8.8.8.8,53,udp,dns,34,225,1,104,1,329,2,normal,-
5920038783491917168,10.0.2.16,8.8.8.8,53,udp,dns,45,112,1,96,1,208,2,normal,-
-6135425735906312520,10.0.2.16,8.8.8.8,53,udp,dns,34,138,1,90,1,228,2,normal,-
-7466701989533680087,10.0.2.16,8.8.8.8,53,udp,dns,94,98,1,82,1,180,2,normal,-
-4148708030616818865,10.0.2.16,8.8.8.8,53,udp,dns,56,388,1,85,1,473,2,normal,-
3349485292013847251,10.0.2.16,8.8.8.8,53,udp,dns,40,152,1,101,1,253,2,normal,-
-3626047380582848071,10.0.2.16,8.8.8.8,53,udp,dns,56,203,1,114,1,317,2,normal,-
-3980692360332049284,10.0.2.16,8.8.8.8,53,udp,dns,68,140,1,84,1,224,2,normal,-
-1761839733417162135,10.0.2.16,151.101.193.16,443,tcp,-,94,60,1,128,2,188,3,normal,-
-9001605129809181619,10.0.2.16,8.8.8.8,53,udp,dns,86,411,2,181,2,592,4,normal,-
450188085674482260,10.0.2.16,8.8.8.8,53,udp,dns,40,211,1,83,1,294,2,normal,-
7257173126505695667,10.0.2.16,8.8.8.8,53,udp,dns,39,117,1,85,1,202,2,normal,-
-7854570303578212040,10.0.2.16,8.8.8.8,53,udp,dns,52,112,1,96,1,208,2,normal,-
4807382797043131559,10.0.2.16,8.8.8.8,53,udp,dns,127,350,1,83,1,433,2,normal,-
1657647441860962920,10.0.2.16,8.8.8.8,53,udp,dns,57,209,1,83,1,292,2,normal,-
1392734657992073271,10.0.2.16,8.8.8.8,53,udp,dns,90,121,1,93,1,214,2,normal,-
7189526577340176961,10.0.2.16,8.8.8.8,53,udp,dns,59,153,1,92,1,245,2,normal,-
3329829361404238844,10.0.2.16,8.8.8.8,53,udp,dns,47,210,1,118,1,328,2,normal,-
6278335266751493169,10.0.2.16,8.8.8.8,53,udp,dns,87,320,1,89,1,409,2,normal,-
6787668541451036702,10.0.2.16,74.115.50.110,80,tcp,http,10477,869,6,686,6,1555,12,normal,-
3704728889495145926,10.0.2.16,8.8.8.8,53,udp,dns,51,121,1,84,1,205,2,normal,-
1684424226316014285,10.0.2.16,8.8.8.8,53,udp,dns,58,178,1,97,1,275,2,normal,-
127951539563529261,10.0.2.16,8.8.8.8,53,udp,dns,51,152,1,96,1,248,2,normal,-
-8027086071511650610,10.0.2.16,142.251.36.138,443,udp,-,264,13702,14,2614,13,16316,27,normal,-
-7605111411117673846,10.0.2.16,8.8.8.8,53,udp,dns,50,131,1,99,1,230,2,normal,-
-8679629241711217680,10.0.2.16,8.8.8.8,53,udp,dns,75,218,1,95,1,313,2,normal,-
4262011312761223692,10.0.2.16,8.8.8.8,53,udp,dns,66,118,1,86,1,204,2,normal,-
2183219996131546906,10.0.2.16,8.8.8.8,53,udp,dns,41,206,1,95,1,301,2,normal,-
-2052784754439709976,10.0.2.16,8.8.8.8,53,udp,dns,56,129,1,101,1,230,2,normal,-
5960408880949827914,10.0.2.16,142.251.36.131,443,udp,-,224,7202,10,2674,13,9876,23,normal,-
5210639104694373942,10.0.2.16,8.8.8.8,53,udp,dns,165,158,1,94,1,252,2,normal,-
4355324067262859295,10.0.2.16,8.8.8.8,53,udp,dns,44,178,1,97,1,275,2,normal,-
-2301482444188958360,10.0.2.16,8.8.8.8,53,udp,dns,44,207,1,114,1,321,2,normal,-
3852422313419815094,10.0.2.16,8.8.8.8,53,udp,dns,45,167,1,83,1,250,2,normal,-
6013098187288890546,10.0.2.16,8.8.8.8,53,udp,dns,187,135,1,84,1,219,2,normal,-
-4313665996235896387,10.0.2.16,8.8.8.8,53,udp,dns,56,142,1,86,1,228,2,normal,-
329426091871924019,10.0.2.16,8.8.8.8,53,udp,dns,99,164,1,98,1,262,2,normal,-
-3885396213286935415,10.0.2.16,8.8.8.8,53,udp,dns,54,201,1,86,1,287,2,normal,-
-5299204447128180028,10.0.2.16,8.8.8.8,53,udp,dns,63,156,1,87,1,243,2,normal,-
-3573708694196606962,10.0.2.16,8.8.8.8,53,udp,dns,50,166,1,105,1,271,2,normal,-
7046116554760554717,10.0.2.16,8.8.8.8,53,udp,dns,154,130,1,102,1,232,2,normal,-
-3953654917864008859,10.0.2.16,8.8.8.8,53,udp,dns,86,354,1,89,1,443,2,normal,-
-7682915944261359327,10.0.2.16,8.8.8.8,53,udp,dns,91,268,1,100,1,368,2,normal,-
-3807448680741534460,10.0.2.16,8.8.8.8,53,udp,dns,73,132,1,83,1,215,2,normal,-
-7598350120428867504,10.0.2.16,8.8.8.8,53,udp,dns,130,142,1,90,1,232,2,normal,-
1406421811809227271,10.0.2.16,8.8.8.8,53,udp,dns,42,116,1,84,1,200,2,normal,-
-7834448246186122753,10.0.2.16,8.8.8.8,53,udp,dns,66,313,1,89,1,402,2,normal,-
3431871243598650439,10.0.2.16,8.8.8.8,53,udp,dns,51,178,1,87,1,265,2,normal,-
1150929581668300243,10.0.2.16,8.8.8.8,53,udp,dns,61,183,1,92,1,275,2,normal,-
-409409184889131743,10.0.2.16,8.8.8.8,53,udp,dns,46,180,1,95,1,275,2,normal,-
6230173509281814389,10.0.2.16,8.8.8.8,53,udp,dns,64,158,1,87,1,245,2,normal,-
3172540135457629153,10.0.2.16,8.8.8.8,53,udp,dns,69,207,1,114,1,321,2,normal,-
1202826313849554792,10.0.2.16,8.8.8.8,53,udp,dns,44,145,1,96,1,241,2,normal,-
-573959268066974943,10.0.2.16,157.240.30.27,443,udp,-,197,5560,8,1828,5,7388,13,normal,-
1879329292579699093,10.0.2.16,8.8.8.8,53,udp,dns,80,121,1,93,1,214,2,normal,-
4805215539167689687,10.0.2.16,8.8.8.8,53,udp,dns,64,141,1,87,1,228,2,normal,-
4014145247421514018,10.0.2.16,8.8.8.8,53,udp,dns,54,150,1,86,1,236,2,normal,-
5837652831907113980,10.0.2.16,8.8.8.8,53,udp,dns,61,116,1,100,1,216,2,normal,-
8827994172635007402,10.0.2.16,8.8.8.8,53,udp,dns,52,152,1,96,1,248,2,normal,-
5780720112707508401,10.0.2.16,8.8.8.8,53,udp,dns,97,180,1,84,1,264,2,normal,-
-5850043827401144828,10.0.2.16,8.8.8.8,53,udp,dns,52,150,1,90,1,240,2,normal,-
-7520545587285182023,10.0.2.16,8.8.8.8,53,udp,dns,56,162,1,98,1,260,2,normal,-
-8773477020656562176,10.0.2.16,142.251.37.110,443,udp,-,199,9623,10,2155,9,11778,19,normal,-
2397929039493965319,10.0.2.16,8.8.8.8,53,udp,dns,42,179,1,81,1,260,2,normal,-
3674261273529125501,10.0.2.16,8.8.8.8,53,udp,dns,58,104,1,88,1,192,2,normal,-
-6695500119597880896,10.0.2.16,157.240.30.174,443,udp,-,98,5798,10,2367,10,8165,20,normal,-
2780090402971979493,10.0.2.16,8.8.8.8,53,udp,dns,51,100,1,84,1,184,2,normal,-
-2037655158625071495,10.0.2.16,8.8.8.8,53,udp,dns,75,167,1,87,1,254,2,normal,-
214467324360414025,10.0.2.16,104.17.50.95,443,udp,-,488,6453,10,1833,5,8286,15,normal,-
6145334937677911329,10.0.2.16,142.251.36.97,443,udp,-,538,24624,27,4098,22,28722,49,normal,-
5441896472030010647,10.0.2.16,142.251.36.78,443,udp,-,24265,2121252,1637,152999,607,2274251,2244,normal,-
931441267322648133,10.0.2.16,8.8.8.8,53,udp,dns,55,239,1,91,1,330,2,normal,-
7171759845301937847,10.0.2.16,142.251.37.106,443,udp,-,3041,8632,13,2479,10,11111,23,normal,-
8008256252216881065,10.0.2.16,8.8.8.8,53,udp,dns,49,152,1,96,1,248,2,normal,-
-4450925022523856211,10.0.2.16,8.8.8.8,53,udp,dns,51,155,1,82,1,237,2,normal,-
7339873216405982810,10.0.2.16,8.8.8.8,53,udp,dns,58,135,1,88,1,223,2,normal,-
8762340801263900234,10.0.2.16,8.8.8.8,53,udp,dns,88,189,1,85,1,274,2,normal,-
6041492494633066600,10.0.2.16,8.8.8.8,53,udp,dns,73,116,1,88,1,204,2,normal,-
1293479405195625452,10.0.2.16,8.8.8.8,53,udp,dns,59,158,1,96,1,254,2,normal,-
2501076402235373229,10.0.2.16,142.251.37.99,443,tcp,-,49,60,1,128,2,188,3,normal,-
-2858552091377217471,10.0.2.16,8.8.8.8,53,udp,dns,72,112,1,96,1,208,2,normal,-
-8088453289524855012,10.0.2.16,8.8.8.8,53,udp,dns,56,190,1,142,1,332,2,normal,-
-553972621435449136,10.0.2.16,8.8.8.8,53,udp,dns,83,199,1,102,1,301,2,normal,-
-3200529809116031005,10.0.2.16,8.8.8.8,53,udp,dns,44,204,1,122,1,326,2,normal,-
-7758312344286128026,10.0.2.16,142.251.36.131,80,tcp,http,79686,6944,23,4728,24,11672,47,normal,-
-6158801717691794031,10.0.2.16,8.8.8.8,53,udp,dns,43,108,1,92,1,200,2,normal,-
7635938734401549711,10.0.2.16,8.8.8.8,53,udp,dns,49,214,1,90,1,304,2,normal,-
4256281590544230131,10.0.2.16,8.8.8.8,53,udp,dns,36,207,1,114,1,321,2,normal,-
5032156072127063051,10.0.2.16,142.251.37.99,443,udp,-,284,7116,9,2365,10,9481,19,normal,-
-2280822146912389876,10.0.2.16,8.8.8.8,53,udp,dns,74,146,1,81,1,227,2,normal,-
-6199818360678439002,10.0.2.16,8.8.8.8,53,udp,dns,66,272,1,90,1,362,2,normal,-
-2280863155266043817,10.0.2.16,157.240.30.174,443,udp,-,125,5799,10,2168,8,7967,18,normal,-
-8794983058285424701,10.0.2.16,142.251.36.142,443,udp,-,280,9639,10,1982,7,11621,17,normal,-
-3762895176773940547,10.0.2.16,77.75.78.118,443,tcp,tls,170647,8683,23,2480,23,11163,46,normal,-
-5596765568857882509,10.0.2.16,8.8.8.8,53,udp,dns,62,120,1,88,1,208,2,normal,-
5061893432167574292,10.0.2.16,8.8.8.8,53,udp,dns,71,100,1,84,1,184,2,normal,-
1706192593327979383,10.0.2.16,142.251.37.104,443,udp,-,2697,51886,42,2351,9,54237,51,normal,-
4567255788858439179,10.0.2.16,8.8.8.8,53,udp,dns,52,230,1,88,1,318,2,normal,-
-8047732572114122743,10.0.2.16,8.8.8.8,53,udp,dns,66,207,1,88,1,295,2,normal,-
-2848263722369581985,10.0.2.16,8.8.8.8,53,udp,dns,62,115,1,87,1,202,2,normal,-
7746858050754372700,10.0.2.16,8.8.8.8,53,udp,dns,41,163,1,92,1,255,2,normal,-
3556450511963774724,10.0.2.16,8.8.8.8,53,udp,dns,42,170,1,88,1,258,2,normal,-
7340734583671227413,10.0.2.16,8.8.8.8,53,udp,dns,50319,149,1,182,2,331,3,normal,-
8370096537547742394,10.0.2.16,8.8.8.8,53,udp,dns,44,170,1,88,1,258,2,normal,-
597881509599151428,10.0.2.16,8.8.8.8,53,udp,dns,53,132,1,83,1,215,2,normal,-
2469907795246911867,10.0.2.16,8.8.8.8,53,udp,dns,66,178,1,97,1,275,2,normal,-
-6754473847301022278,10.0.2.16,8.8.8.8,53,udp,dns,60,178,1,97,1,275,2,normal,-
-4753640861368905987,10.0.2.16,216.239.34.36,443,udp,-,10494,9117,29,5793,22,14910,51,normal,-
4736695008364679615,10.0.2.16,8.8.8.8,53,udp,dns,41,250,1,122,1,372,2,normal,-
2269857960372935532,10.0.2.16,8.8.8.8,53,udp,dns,53,114,1,86,1,200,2,normal,-
-2475503082136316503,10.0.2.16,8.8.8.8,53,udp,dns,47,184,1,114,1,298,2,normal,-
-403327965273572504,10.0.2.16,8.8.8.8,53,udp,dns,62,133,1,94,1,227,2,normal,-
-1812458725499954038,10.0.2.16,8.8.8.8,53,udp,dns,58,184,1,85,1,269,2,normal,-
8914876301642676169,10.0.2.16,8.8.8.8,53,udp,dns,109,145,1,89,1,234,2,normal,-
-474126105254971199,10.0.2.16,8.8.8.8,53,udp,dns,50,132,1,87,1,219,2,normal,-
-7562175553896329300,10.0.2.16,8.8.8.8,53,udp,dns,35,156,1,91,1,247,2,normal,-
3019441284909679398,10.0.2.16,8.8.8.8,53,udp,dns,54,148,1,92,1,240,2,normal,-
8130506601034581643,10.0.2.16,8.8.8.8,53,udp,dns,47,208,1,85,1,293,2,normal,-
-2631162121879015951,10.0.2.16,8.8.8.8,53,udp,dns,53,147,1,91,1,238,2,normal,-
4054531792790240372,10.0.2.16,8.8.8.8,53,udp,dns,97,139,1,91,1,230,2,normal,-
6184429419224977853,10.0.2.16,8.8.8.8,53,udp,dns,48,113,1,85,1,198,2,normal,-
-5830950078747762673,10.0.2.16,8.8.8.8,53,udp,dns,45,118,1,90,1,208,2,normal,-
314708292890167751,10.0.2.16,8.8.8.8,53,udp,dns,68,133,1,80,1,213,2,normal,-
-1083500029782425297,10.0.2.16,95.100.146.66,80,tcp,http,66861,1543,11,1091,12,2634,23,normal,-
-4369724733798010600,10.0.2.16,8.8.8.8,53,udp,dns,68,268,1,100,1,368,2,normal,-
-81358996453305949,10.0.2.16,216.239.34.36,443,udp,-,459,8250,10,2671,13,10921,23,normal,-
7911252666204276402,10.0.2.16,8.8.8.8,53,udp,dns,98,190,1,83,1,273,2,normal,-
2419880303845028407,10.0.2.16,8.8.8.8,53,udp,dns,50,149,1,92,1,241,2,normal,-
-8275272512219269848,10.0.2.16,8.8.8.8,53,udp,dns,43,129,1,101,1,230,2,normal,-
-2741938438830123466,10.0.2.16,8.8.8.8,53,udp,dns,127334,357,2,186,2,543,4,normal,-
-7996556776936363429,10.0.2.16,8.8.8.8,53,udp,dns,59,141,1,82,1,223,2,normal,-
-8115991276691196187,10.0.2.16,8.8.8.8,53,udp,dns,52,153,1,97,1,250,2,normal,-
1693871981848829610,10.0.2.16,8.8.8.8,53,udp,dns,53,156,1,83,1,239,2,normal,-
8754867113106185000,10.0.2.16,8.8.8.8,53,udp,dns,103,124,1,92,1,216,2,normal,-
6647084721857948344,10.0.2.16,8.8.8.8,53,udp,dns,54,101,1,85,1,186,2,normal,-
3936782668482815097,10.0.2.16,8.8.8.8,53,udp,dns,48,137,1,84,1,221,2,normal,-
-6584173260529537239,10.0.2.16,8.8.8.8,53,udp,dns,41,104,1,88,1,192,2,normal,-
-8574871675007893058,10.0.2.16,8.8.8.8,53,udp,dns,49,134,1,81,1,215,2,normal,-
-3662209451202938415,10.0.2.16,8.8.8.8,53,udp,dns,143,134,1,78,1,212,2,normal,-
5170845652350527301,10.0.2.16,8.8.8.8,53,udp,dns,101,156,1,100,1,256,2,normal,-
-1927186202118287175,10.0.2.16,142.251.37.99,443,udp,-,8075,9818,29,5957,29,15775,58,normal,-
6775331049272956033,10.0.2.16,8.8.8.8,53,udp,dns,61,151,1,95,1,246,2,normal,-
-3572788955944113818,10.0.2.16,151.101.193.16,443,tcp,-,94,60,1,128,2,188,3,normal,-
-1687040861520060932,10.0.2.16,8.8.8.8,53,udp,dns,66,139,1,107,1,246,2,normal,-
-2989211411144953427,10.0.2.16,8.8.8.8,53,udp,dns,38,173,1,108,1,281,2,normal,-
1973837389128151335,10.0.2.16,185.125.190.56,123,udp,ntp,90,90,1,90,1,180,2,normal,-
-127864986171110741,10.0.2.16,8.8.8.8,53,udp,dns,51,141,1,82,1,223,2,normal,-
8967504016059706610,10.0.2.16,8.8.8.8,53,udp,dns,47,184,1,85,1,269,2,normal,-
-8736663126275387926,10.0.2.16,8.8.8.8,53,udp,dns,59,190,1,92,1,282,2,normal,-
-4697505427852991209,10.0.2.16,8.8.8.8,53,udp,dns,46,307,1,101,1,408,2,normal,-
6092407631797836854,10.0.2.16,8.8.8.8,53,udp,dns,51,152,1,96,1,248,2,normal,-
6591982966843293633,10.0.2.16,87.244.225.145,443,udp,-,154,5252,8,1828,5,7080,13,normal,-
6231819612953181519,10.0.2.16,142.250.27.156,443,udp,-,1304,8202,17,3478,15,11680,32,normal,-
-323893245925976780,10.0.2.16,8.8.8.8,53,udp,dns,46,132,1,83,1,215,2,normal,-
-6786702991607642716,10.0.2.16,151.101.193.16,443,tcp,-,98,60,1,128,2,188,3,normal,-
-6938675240877022978,10.0.2.16,8.8.8.8,53,udp,dns,114,121,1,89,1,210,2,normal,-
1676741190514345075,10.0.2.16,8.8.8.8,53,udp,dns,85,170,1,90,1,260,2,normal,-
-6169137968634599922,10.0.2.16,8.8.8.8,53,udp,dns,65,191,1,87,1,278,2,normal,-
5956454496120074299,10.0.2.16,8.8.8.8,53,udp,dns,74,207,1,114,1,321,2,normal,-
-5398960244622928597,10.0.2.16,8.8.8.8,53,udp,dns,48,147,1,84,1,231,2,normal,-
-3744533988951539368,10.0.2.16,157.240.30.35,443,udp,-,281,9095,13,2457,10,11552,23,normal,-
-3014748202791448548,10.0.2.16,8.8.8.8,53,udp,dns,50,121,1,89,1,210,2,normal,-
613508557781322704,10.0.2.16,8.8.8.8,53,udp,dns,34,113,1,85,1,198,2,normal,-
1339525693117041949,10.0.2.16,142.251.36.137,443,udp,-,262,7109,9,2231,10,9340,19,normal,-
4597074813637033656,10.0.2.16,8.8.8.8,53,udp,dns,63,164,1,98,1,262,2,normal,-
-1284431976843296929,10.0.2.16,8.8.8.8,53,udp,dns,48,133,1,88,1,221,2,normal,-
-6858929890061109708,10.0.2.16,8.8.8.8,53,udp,dns,276824,227,2,167,2,394,4,normal,-
836489851095827884,10.0.2.16,8.8.8.8,53,udp,dns,59,178,1,85,1,263,2,normal,-
7687609026379590177,10.0.2.16,8.8.8.8,53,udp,dns,67,167,1,83,1,250,2,normal,-
7494771053437392448,10.0.2.16,8.8.8.8,53,udp,dns,5076,130,1,164,2,294,3,normal,-
4842456941734964314,10.0.2.16,8.8.8.8,53,udp,dns,58,141,1,85,1,226,2,normal,-
4399630311969023597,10.0.2.16,8.8.8.8,53,udp,dns,51,232,1,86,1,318,2,normal,-
9093650665157868068,10.0.2.16,8.8.8.8,53,udp,dns,5456,152,1,180,2,332,3,normal,-
7987047528306841426,10.0.2.16,8.8.8.8,53,udp,dns,51,143,1,86,1,229,2,normal,-
-8340602756209611610,10.0.2.16,8.8.8.8,53,udp,dns,58,164,1,98,1,262,2,normal,-
1661608832219713454,10.0.2.16,192.124.249.41,80,tcp,http,38707,7752,15,2131,16,9883,31,normal,-
4939716561603554479,10.0.2.16,52.97.189.66,443,udp,-,432,25119,25,4332,16,29451,41,normal,-
6941716533353815371,10.0.2.16,8.8.8.8,53,udp,dns,47,141,1,82,1,223,2,normal,-
-2750011668027146675,10.0.2.16,8.8.8.8,53,udp,dns,113,246,1,86,1,332,2,normal,-
3682453329550369864,10.0.2.16,8.8.8.8,53,udp,dns,49,142,1,86,1,228,2,normal,-
3658168098564473345,10.0.2.16,8.8.8.8,53,udp,dns,57,129,1,87,1,216,2,normal,-
-2625694225887959018,10.0.2.16,8.8.8.8,53,udp,dns,59,133,1,78,1,211,2,normal,-
-7116188857793234191,10.0.2.16,8.8.8.8,53,udp,dns,59,164,1,111,1,275,2,normal,-
-3627812949961097958,10.0.2.16,8.8.8.8,53,udp,dns,74,207,1,95,1,302,2,normal,-
-315559358715964511,10.0.2.16,8.8.8.8,53,udp,dns,94,112,1,96,1,208,2,normal,-
-6083662895601693091,10.0.2.16,8.8.8.8,53,udp,dns,61,160,1,89,1,249,2,normal,-
3215657288870971199,10.0.2.16,8.8.8.8,53,udp,dns,46,101,1,85,1,186,2,normal,-
-6962469328541837700,10.0.2.16,142.251.36.132,443,udp,-,244,3821,11,2585,10,6406,21,normal,-
-7404301374343017575,10.0.2.16,8.8.8.8,53,udp,dns,42,141,1,82,1,223,2,normal,-
-9140014551393175378,10.0.2.16,8.8.8.8,53,udp,dns,100,249,1,90,1,339,2,normal,-
-2797672880798524705,10.0.2.16,8.8.8.8,53,udp,dns,48,179,1,114,1,293,2,normal,-
-8201869039031904877,10.0.2.16,8.8.8.8,53,udp,dns,62,149,1,92,1,241,2,normal,-
-6141456982066543273,10.0.2.16,8.8.8.8,53,udp,dns,43,307,1,101,1,408,2,normal,-
1126817507456223545,10.0.2.16,8.8.8.8,53,udp,dns,44,243,1,86,1,329,2,normal,-
-4009070111326106848,10.0.2.16,8.8.8.8,53,udp,dns,62,112,1,84,1,196,2,normal,-
1383933475786632554,10.0.2.16,8.8.8.8,53,udp,dns,61,160,1,90,1,250,2,normal,-
-2580811503096367085,10.0.2.16,8.8.8.8,53,udp,dns,55,153,1,84,1,237,2,normal,-
-1763186464888655229,10.0.2.16,74.115.50.110,80,tcp,-,6377,180,3,236,4,416,7,normal,-
6809779374427838622,10.0.2.16,8.8.8.8,53,udp,dns,58,148,1,92,1,240,2,normal,-
8400776929591581474,10.0.2.16,8.8.8.8,53,udp,dns,54,158,1,94,1,252,2,normal,-
-7118079702010133494,10.0.2.16,8.8.8.8,53,udp,dns,41,154,1,93,1,247,2,normal,-
6399218656518238670,10.0.2.16,8.8.8.8,53,udp,dns,46,148,1,92,1,240,2,normal,-
-8405933000199953372,10.0.2.16,8.8.8.8,53,udp,dns,105,134,1,86,1,220,2,normal,-
-7702687336364733780,10.0.2.16,8.8.8.8,53,udp,dns,53,117,1,101,1,218,2,normal,-
3802045416139524037,10.0.2.16,8.8.8.8,53,udp,dns,60,143,1,86,1,229,2,normal,-
8240634326798263210,10.0.2.16,8.8.8.8,53,udp,dns,59,148,1,94,1,242,2,normal,-
-1424590411455422085,10.0.2.16,8.8.8.8,53,udp,dns,180,129,1,90,1,219,2,normal,-
7050794028375417796,10.0.2.16,8.8.8.8,53,udp,dns,134,144,1,87,1,231,2,normal,-
7355150858709746489,10.0.2.16,8.8.8.8,53,udp,dns,62,137,1,109,1,246,2,normal,-
-4151194905631219403,10.0.2.16,142.251.36.99,443,udp,-,315,7008,8,1987,7,8995,15,normal,-
-6056116823822591635,10.0.2.16,142.251.36.78,443,udp,-,327,7332,8,1980,7,9312,15,normal,-
-8102042296648105559,10.0.2.16,8.8.8.8,53,udp,dns,41,233,1,101,1,334,2,normal,-
-1902625732271545614,10.0.2.16,142.251.37.106,443,udp,-,291,2290,4,1628,3,3918,7,normal,-
-1915468447388094831,10.0.2.16,8.8.8.8,53,udp,dns,145,139,1,75,1,214,2,normal,-
-8120345622925293860,10.0.2.16,8.8.8.8,53,udp,dns,49,189,1,90,1,279,2,normal,-
-1880070007102549102,10.0.2.16,8.8.8.8,53,udp,dns,69,156,1,83,1,239,2,normal,-
-6394849869993720794,10.0.2.16,8.8.8.8,53,udp,dns,217,116,1,84,1,200,2,normal,-
8040438463295213017,10.0.2.16,8.8.8.8,53,udp,dns,54,156,1,95,1,251,2,normal,-
-6869340972313256299,10.0.2.16,104.18.32.68,80,tcp,http,38309,2460,9,1408,10,3868,19,normal,-
6738981234446439927,10.0.2.16,8.8.8.8,53,udp,dns,37,163,1,98,1,261,2,normal,-
1341677689638535111,10.0.2.16,8.8.8.8,53,udp,dns,57,143,1,90,1,233,2,normal,-
2130801115814463393,10.0.2.16,8.8.8.8,53,udp,dns,47,138,1,93,1,231,2,normal,-
1657084091691789100,10.0.2.16,8.8.8.8,53,udp,dns,71,158,1,98,1,256,2,normal,-
5364451276018443102,10.0.2.16,8.8.8.8,53,udp,dns,110,163,1,102,1,265,2,normal,-
4492943066470659200,10.0.2.16,8.8.8.8,53,udp,dns,122,163,1,102,1,265,2,normal,-
1295955203019226789,10.0.2.16,8.8.8.8,53,udp,dns,42,212,1,87,1,299,2,normal,-
8231123765794574815,10.0.2.16,8.8.8.8,53,udp,dns,61,189,1,90,1,279,2,normal,-
6542952974691573888,10.0.2.16,8.8.8.8,53,udp,dns,129,166,1,109,1,275,2,normal,-
-5762691374170689229,10.0.2.16,8.8.8.8,53,udp,dns,59,184,1,85,1,269,2,normal,-
-8180123243450333609,10.0.2.16,8.8.8.8,53,udp,dns,53,157,1,84,1,241,2,normal,-
6392006794586460064,10.0.2.16,8.8.8.8,53,udp,dns,51,336,1,91,1,427,2,normal,-
-5721260428314605510,10.0.2.16,8.8.8.8,53,udp,dns,98,170,1,88,1,258,2,normal,-
6107386088792582182,10.0.2.16,8.8.8.8,53,udp,dns,67,103,1,87,1,190,2,normal,-
6872695457852504549,10.0.2.16,8.8.8.8,53,udp,dns,51,158,1,82,1,240,2,normal,-
2416388493089122905,10.0.2.16,8.8.8.8,53,udp,dns,56,207,1,114,1,321,2,normal,-
8812368292665783694,10.0.2.16,8.8.8.8,53,udp,dns,51,117,1,85,1,202,2,normal,-
-3452431232160045306,10.0.2.16,8.8.8.8,53,udp,dns,142,135,1,86,1,221,2,normal,-
9136966007216422828,10.0.2.16,8.8.8.8,53,udp,dns,50,149,1,92,1,241,2,normal,-
-105931446383113711,10.0.2.16,8.8.8.8,53,udp,dns,59,163,1,97,1,260,2,normal,-
4996825014403169158,10.0.2.16,8.8.8.8,53,udp,dns,54,176,1,95,1,271,2,normal,-
7308962245307957287,10.0.2.16,8.8.8.8,53,udp,dns,51,363,1,91,1,454,2,normal,-
-4437983438375084044,10.0.2.16,8.8.8.8,53,udp,dns,37,183,1,81,1,264,2,normal,-
8109734784242118840,10.0.2.16,8.8.8.8,53,udp,dns,65,131,1,86,1,217,2,normal,-
-6488898716921951584,10.0.2.16,8.8.8.8,53,udp,dns,186,144,1,87,1,231,2,normal,-
-3061824461956124544,10.0.2.16,8.8.8.8,53,udp,dns,59,140,1,92,1,232,2,normal,-
-7939024516697449875,10.0.2.16,8.8.8.8,53,udp,dns,47,176,1,95,1,271,2,normal,-
-1460440682394247315,10.0.2.16,8.8.8.8,53,udp,dns,53,138,1,90,1,228,2,normal,-
-7988192877352050208,10.0.2.16,142.251.36.67,80,tcp,-,5403,180,3,236,4,416,7,normal,-
7631261260786686632,10.0.2.16,8.8.8.8,53,udp,dns,39,207,1,114,1,321,2,normal,-
3932381608526494587,10.0.2.16,8.8.8.8,53,udp,dns,94,130,1,91,1,221,2,normal,-
2339004310712895770,10.0.2.16,8.8.8.8,53,udp,dns,55,148,1,91,1,239,2,normal,-
-5715078043334481604,10.0.2.16,8.8.8.8,53,udp,dns,63,290,1,100,1,390,2,normal,-
3363612539021576995,10.0.2.16,8.8.8.8,53,udp,dns,160,152,1,90,1,242,2,normal,-
-5906363222976248101,10.0.2.16,8.8.8.8,53,udp,dns,73,148,1,92,1,240,2,normal,-
-4799547310047402804,10.0.2.16,8.8.8.8,53,udp,dns,101,96,1,80,1,176,2,normal,-
-8244267824581717794,10.0.2.16,8.8.8.8,53,udp,dns,49,156,1,92,1,248,2,normal,-
-8411639950766471151,10.0.2.16,8.8.8.8,53,udp,dns,36,118,1,102,1,220,2,normal,-
-7800875111590423005,10.0.2.16,192.229.221.95,80,tcp,-,6286,180,3,310,5,490,8,normal,-
-1507862840590164499,10.0.2.16,8.8.8.8,53,udp,dns,65,157,1,103,1,260,2,normal,-
-2172668824626905124,10.0.2.16,8.8.8.8,53,udp,dns,46,132,1,83,1,215,2,normal,-
-3883891301921674588,10.0.2.16,8.8.8.8,53,udp,dns,48,99,1,83,1,182,2,normal,-
-5455556053856574439,10.0.2.16,8.8.8.8,53,udp,dns,53,158,1,94,1,252,2,normal,-
-979490192902266202,10.0.2.16,8.8.8.8,53,udp,dns,58,115,1,99,1,214,2,normal,-
-5522009585084191138,10.0.2.16,142.251.36.132,443,udp,-,9027,14991,36,7756,28,22747,64,normal,-
7270260739283541692,10.0.2.16,8.8.8.8,53,udp,dns,65,132,1,83,1,215,2,normal,-
-5409938213171643972,10.0.2.16,157.240.30.174,443,udp,-,7434,660586,588,60748,191,721334,779,normal,-
-8283393623351463462,10.0.2.16,8.8.8.8,53,udp,dns,43,199,1,95,1,294,2,normal,-
-6502523401371329238,10.0.2.16,8.8.8.8,53,udp,dns,58,152,1,90,1,242,2,normal,-
-6772352098855155711,10.0.2.16,142.251.37.106,443,udp,-,6189,28226,39,12794,31,41020,70,normal,-
1091680557293517720,10.0.2.16,8.8.8.8,53,udp,dns,88,100,1,84,1,184,2,normal,-
3090802775060251913,10.0.2.16,8.8.8.8,53,udp,dns,48,111,1,83,1,194,2,normal,-
-4399012952683622555,10.0.2.16,31.30.189.14,443,udp,-,210,33208,28,3686,14,36894,42,normal,-
3293461822014656680,10.0.2.16,8.8.8.8,53,udp,dns,52,209,1,84,1,293,2,normal,-
-7745742020410299480,10.0.2.16,8.8.8.8,53,udp,dns,49,108,1,92,1,200,2,normal,-
8293590278786878352,10.0.2.16,8.8.8.8,53,udp,dns,33,132,1,83,1,215,2,normal,-
4159019778401884963,10.0.2.16,157.240.19.26,443,udp,-,526,8821,17,2290,9,11111,26,normal,-
4575913971662164422,10.0.2.16,8.8.8.8,53,udp,dns,64,195,1,89,1,284,2,normal,-
4980985190143179227,10.0.2.16,8.8.8.8,53,udp,dns,48,204,1,92,1,296,2,normal,-
-1685687088974693258,10.0.2.16,8.8.8.8,53,udp,dns,42,233,1,101,1,334,2,normal,-
6801121191624113379,10.0.2.16,8.8.8.8,53,udp,dns,76,116,1,84,1,200,2,normal,-
-1253965529090224072,10.0.2.16,8.8.8.8,53,udp,dns,68,143,1,86,1,229,2,normal,-
1552952344525414644,10.0.2.16,8.8.8.8,53,udp,dns,64,127,1,95,1,222,2,normal,-
1749430174712643073,10.0.2.16,8.8.8.8,53,udp,dns,50,138,1,97,1,235,2,normal,-
-1892871505707642101,10.0.2.16,142.251.36.100,443,udp,-,8043,17881,59,6611,51,24492,110,normal,-
-7356688043506809950,10.0.2.16,8.8.8.8,53,udp,dns,94,142,1,91,1,233,2,normal,-
-944203272132614792,10.0.2.16,8.8.8.8,53,udp,dns,66,148,1,92,1,240,2,normal,-
-1624963373710163826,10.0.2.16,8.8.8.8,53,udp,dns,38,116,1,84,1,200,2,normal,-
3429155559089737412,10.0.2.16,8.8.8.8,53,udp,dns,107,150,1,86,1,236,2,normal,-
-4724995533084161979,10.0.2.16,8.8.8.8,53,udp,dns,46,161,1,103,1,264,2,normal,-
2045276701330034027,10.0.2.16,8.8.8.8,53,udp,dns,85,146,1,81,1,227,2,normal,-
2682725994392430977,10.0.2.16,8.8.8.8,53,udp,dns,90,170,1,88,1,258,2,normal,-
-3778334837320881709,10.0.2.16,8.8.8.8,53,udp,dns,83,336,1,102,1,438,2,normal,-
7593736428555947163,10.0.2.16,8.8.8.8,53,udp,dns,48,132,1,83,1,215,2,normal,-
-4946348588613793981,10.0.2.16,142.251.36.67,443,udp,-,209,7667,7,1980,7,9647,14,normal,-
-2032786803673322537,10.0.2.16,8.8.8.8,53,udp,dns,134,132,1,87,1,219,2,normal,-
-7298792791677395101,10.0.2.16,8.8.8.8,53,udp,dns,48,100,1,84,1,184,2,normal,-
3942965053462939003,10.0.2.16,8.8.8.8,53,udp,dns,119,339,2,193,2,532,4,normal,-
4935214821588700500,10.0.2.16,8.8.8.8,53,udp,dns,90,116,1,84,1,200,2,normal,-
-5555459897840448206,10.0.2.16,8.8.8.8,53,udp,dns,94,116,1,84,1,200,2,normal,-
-6098100774077740381,10.0.2.16,8.8.8.8,53,udp,dns,48,187,1,116,1,303,2,normal,-
-919078277319001884,10.0.2.16,8.8.8.8,53,udp,dns,54,148,1,92,1,240,2,normal,-
-8089314656790099615,10.0.2.16,8.8.8.8,53,udp,dns,63,239,1,95,1,334,2,normal,-
-7472928337630956197,10.0.2.16,142.251.36.142,443,udp,-,240,9740,11,2363,10,12103,21,normal,-
-6057571229307298553,10.0.2.16,8.8.8.8,53,udp,dns,134,119,1,91,1,210,2,normal,-
-1443145920224325043,10.0.2.16,8.8.8.8,53,udp,dns,40,207,1,114,1,321,2,normal,-
-8299234615824400961,10.0.2.16,8.8.8.8,53,udp,dns,49,99,1,83,1,182,2,normal,-
7360413285931311602,10.0.2.16,8.8.8.8,53,udp,dns,46,178,1,97,1,275,2,normal,-
3230635745865716527,10.0.2.16,8.8.8.8,53,udp,dns,79,102,1,86,1,188,2,normal,-
1420272645158414446,10.0.2.16,8.8.8.8,53,udp,dns,49,148,1,92,1,240,2,normal,-
-760023481994142306,10.0.2.16,8.8.8.8,53,udp,dns,119,123,1,86,1,209,2,normal,-
6619009663020075540,10.0.2.16,8.8.8.8,53,udp,dns,64,115,1,99,1,214,2,normal,-
-4302432700701718786,10.0.2.16,8.8.8.8,53,udp,dns,96,141,1,82,1,223,2,normal,-
3921479915894356795,10.0.2.16,8.8.8.8,53,udp,dns,47,116,1,84,1,200,2,normal,-
3867939010299039619,10.0.2.16,8.8.8.8,53,udp,dns,56,156,1,83,1,239,2,normal,-
-7727261595381419631,10.0.2.16,8.8.8.8,53,udp,dns,58,163,1,99,1,262,2,normal,-
-533664157660543054,10.0.2.16,8.8.8.8,53,udp,dns,287603,263,2,197,2,460,4,normal,-
5289695198498658025,10.0.2.16,8.8.8.8,53,udp,dns,87,126,1,86,1,212,2,normal,-
-3065339044362505828,10.0.2.16,8.8.8.8,53,udp,dns,53,97,1,81,1,178,2,normal,-
-7482896329862896910,10.0.2.16,8.8.8.8,53,udp,dns,48,100,1,84,1,184,2,normal,-
-6639128360810175699,10.0.2.16,142.251.37.110,443,udp,-,287,9731,11,2450,11,12181,22,normal,-
-5079475909994119504,10.0.2.16,8.8.8.8,53,udp,dns,57,114,1,98,1,212,2,normal,-
-4991800329382898499,10.0.2.16,8.8.8.8,53,udp,dns,56,216,1,138,1,354,2,normal,-
-2095040540587807419,10.0.2.16,8.8.8.8,53,udp,dns,44,116,1,84,1,200,2,normal,-
-1134648687946664900,10.0.2.16,8.8.8.8,53,udp,dns,56,141,1,96,1,237,2,normal,-
-8759475757891695617,10.0.2.16,8.8.8.8,53,udp,dns,61,135,1,84,1,219,2,normal,-
-6024112347283673376,10.0.2.16,8.8.8.8,53,udp,dns,72,145,1,97,1,242,2,normal,-
741340582326891645,10.0.2.16,8.8.8.8,53,udp,dns,45,113,1,85,1,198,2,normal,-
-1736601057926515944,10.0.2.16,8.8.8.8,53,udp,dns,89,215,1,95,1,310,2,normal,-
-2320087529083996412,10.0.2.16,31.30.189.145,443,udp,-,16042,1080847,965,50690,362,1131537,1327,normal,-
-4124452957003026693,10.0.2.16,8.8.8.8,53,udp,dns,62,149,1,92,1,241,2,normal,-
-1186420145289270033,10.0.2.16,8.8.8.8,53,udp,dns,74,100,1,84,1,184,2,normal,-
-1202389821478688146,10.0.2.16,142.251.37.99,443,udp,-,869,212612,161,6901,64,219513,225,normal,-
994879498883143024,10.0.2.16,8.8.8.8,53,udp,dns,52,146,1,81,1,227,2,normal,-
247386039318362019,10.0.2.16,8.8.8.8,53,udp,dns,66,170,1,88,1,258,2,normal,-
-4993422899359432912,10.0.2.16,8.8.8.8,53,udp,dns,47,153,1,89,1,242,2,normal,-
-6078018750506048382,10.0.2.16,8.8.8.8,53,udp,dns,58,239,1,91,1,330,2,normal,-
7482658587661602456,10.0.2.16,8.8.8.8,53,udp,dns,54,114,1,98,1,212,2,normal,-
-9153639235842553032,10.0.2.16,8.8.8.8,53,udp,dns,64,141,1,82,1,223,2,normal,-
-5738576659982354616,10.0.2.16,185.125.190.49,80,tcp,http,110,483,5,377,5,860,10,normal,-
8376149387145501361,10.0.2.16,8.8.8.8,53,udp,dns,130,130,1,90,1,220,2,normal,-
-7722193979855730982,10.0.2.16,142.251.37.99,443,tcp,-,175,60,1,128,2,188,3,normal,-
9097164079351301784,10.0.2.16,8.8.8.8,53,udp,dns,59,251,1,87,1,338,2,normal,-
-6656270843106704941,10.0.2.16,8.8.8.8,53,udp,dns,70,233,1,101,1,334,2,normal,-
-7538951851984240819,10.0.2.16,142.251.37.110,443,udp,-,12771,12324,36,6861,26,19185,62,normal,-
-9197984886962613336,10.0.2.16,8.8.8.8,53,udp,dns,83,238,1,88,1,326,2,normal,-
-982598814976851276,10.0.2.16,142.251.37.99,443,udp,-,237,7111,9,2365,10,9476,19,normal,-
7498285635843773732,10.0.2.16,8.8.8.8,53,udp,dns,56,156,1,83,1,239,2,normal,-
-1972649210228442707,10.0.2.16,8.8.8.8,53,udp,dns,54,148,1,92,1,240,2,normal,-
7537712958556756592,10.0.2.16,8.8.8.8,53,udp,dns,66,163,1,107,1,270,2,normal,-
-3796815262349761558,10.0.2.16,8.8.8.8,53,udp,dns,54,115,1,99,1,214,2,normal,-
-8187742960237122701,10.0.2.16,8.8.8.8,53,udp,dns,99,97,1,81,1,178,2,normal,-
-8792447541699117651,10.0.2.16,8.8.8.8,53,udp,dns,55,112,1,84,1,196,2,normal,-
7289870124297421449,10.0.2.16,172.67.28.68,443,udp,-,1009,43697,49,4294,20,47991,69,normal,-
-1801022052716442698,10.0.2.16,8.8.8.8,53,udp,dns,59,128,1,100,1,228,2,normal,-
-9163732513391879876,10.0.2.16,142.251.36.142,443,udp,-,614,9751,11,2527,12,12278,23,normal,-
-2543486541267794946,10.0.2.16,8.8.8.8,53,udp,dns,74,142,1,84,1,226,2,normal,-
3095298952483117492,10.0.2.16,8.8.8.8,53,udp,dns,68,133,1,88,1,221,2,normal,-
3458437512196800260,10.0.2.16,8.8.8.8,53,udp,dns,110,218,1,95,1,313,2,normal,-
-37995869186805673,10.0.2.16,8.8.8.8,53,udp,dns,48,135,1,84,1,219,2,normal,-
-4533457002737733257,10.0.2.16,8.8.8.8,53,udp,dns,70,122,1,85,1,207,2,normal,-
4893129957596733820,10.0.2.16,157.240.252.13,443,udp,-,15694,16145,31,4836,20,20981,51,normal,-
-8818362958888924413,10.0.2.16,8.8.8.8,53,udp,dns,52,274,1,84,1,358,2,normal,-
5370284900490211763,10.0.2.16,216.239.32.36,443,udp,-,210,2782,8,2532,6,5314,14,normal,-
8107125309838882908,10.0.2.16,52.223.40.198,443,tcp,-,35,60,1,128,2,188,3,normal,-
-9184106851808573457,10.0.2.16,8.8.8.8,53,udp,dns,51,215,1,86,1,301,2,normal,-
2228227993761788255,10.0.2.16,8.8.8.8,53,udp,dns,50,334,1,110,1,444,2,normal,-
7232935777454969553,10.0.2.16,8.8.8.8,53,udp,dns,132,172,1,92,1,264,2,normal,-
-4511759089091332394,10.0.2.16,8.8.8.8,53,udp,dns,47,125,1,93,1,218,2,normal,-
-7725171730409456770,10.0.2.16,8.8.8.8,53,udp,dns,48,111,1,83,1,194,2,normal,-
-6128896352824482848,10.0.2.16,147.229.9.226,443,tcp,-,63,60,1,128,2,188,3,normal,-
-7205480037175759498,10.0.2.16,8.8.8.8,53,udp,dns,53,312,1,91,1,403,2,normal,-
-8529601851151715081,10.0.2.16,8.8.8.8,53,udp,dns,58,194,1,88,1,282,2,normal,-
-3906491157460163624,10.0.2.16,8.8.8.8,53,udp,dns,43,120,1,92,1,212,2,normal,-
5090674840576336390,10.0.2.16,8.8.8.8,53,udp,dns,66,152,1,88,1,240,2,normal,-
-5690792812348585085,10.0.2.16,8.8.8.8,53,udp,dns,88,148,1,84,1,232,2,normal,-
-5161585447920380123,10.0.2.16,8.8.8.8,53,udp,dns,50,132,1,83,1,215,2,normal,-
4472643591761034569,10.0.2.16,8.8.8.8,53,udp,dns,125,187,1,116,1,303,2,normal,-
4324265049675708574,10.0.2.16,8.8.8.8,53,udp,dns,69,194,1,84,1,278,2,normal,-
2883762471370301331,10.0.2.16,8.8.8.8,53,udp,dns,64,194,1,82,1,276,2,normal,-
7164966100908685441,10.0.2.16,8.8.8.8,53,udp,dns,50,154,1,90,1,244,2,normal,-
-8171402591278832020,10.0.2.16,8.8.8.8,53,udp,dns,83,289,1,88,1,377,2,normal,-
6029905851242609675,10.0.2.16,8.8.8.8,53,udp,dns,57,214,1,133,1,347,2,normal,-
-9174846860682128093,10.0.2.16,147.229.9.226,443,tcp,-,51,60,1,128,2,188,3,normal,-
-1089765965155072967,10.0.2.16,8.8.8.8,53,udp,dns,72,128,1,96,1,224,2,normal,-
8614061255519581464,10.0.2.16,8.8.8.8,53,udp,dns,53,116,1,88,1,204,2,normal,-
-925323467769998860,10.0.2.16,8.8.8.8,53,udp,dns,48,132,1,83,1,215,2,normal,-
-6342043888612051237,10.0.2.16,8.8.8.8,53,udp,dns,45,145,1,89,1,234,2,normal,-
1369660200149828952,10.0.2.16,8.8.8.8,53,udp,dns,60,148,1,92,1,240,2,normal,-
-2049594467627041666,10.0.2.16,8.8.8.8,53,udp,dns,49,100,1,84,1,184,2,normal,-
6328828884935857509,10.0.2.16,8.8.8.8,53,udp,dns,58,133,1,86,1,219,2,normal,-
-4344133612201916812,10.0.2.16,8.8.8.8,53,udp,dns,46,145,1,89,1,234,2,normal,-
-9155902257588335714,10.0.2.16,8.8.8.8,53,udp,dns,71,280,1,90,1,370,2,normal,-
-6606842892744129456,10.0.2.16,8.8.8.8,53,udp,dns,80,131,1,85,1,216,2,normal,-
5269420834073728017,10.0.2.16,8.8.8.8,53,udp,dns,44,133,1,84,1,217,2,normal,-
665864968730629871,10.0.2.16,8.8.8.8,53,udp,dns,56,204,1,122,1,326,2,normal,-
-4419475811541351491,10.0.2.16,8.8.8.8,53,udp,dns,65,288,1,92,1,380,2,normal,-
3923872473022504416,10.0.2.16,8.8.8.8,53,udp,dns,5053,101,1,170,2,271,3,normal,-
-6282794864237268714,10.0.2.16,8.8.8.8,53,udp,dns,50,180,1,95,1,275,2,normal,-
3663098922883998649,10.0.2.16,8.8.8.8,53,udp,dns,56,171,1,87,1,258,2,normal,-
8355054442972273152,10.0.2.16,8.8.8.8,53,udp,dns,49,170,1,88,1,258,2,normal,-
-8467218897420709056,10.0.2.16,8.8.8.8,53,udp,dns,59,169,1,91,1,260,2,normal,-
-4819820506259385244,10.0.2.16,8.8.8.8,53,udp,dns,45,148,1,92,1,240,2,normal,-
7700407611126646870,10.0.2.16,8.8.8.8,53,udp,dns,110,206,1,95,1,301,2,normal,-
-7493655023093319228,10.0.2.16,8.8.8.8,53,udp,dns,75,132,1,87,1,219,2,normal,-
-7879759144661144690,10.0.2.16,157.240.252.60,443,udp,-,388,8719,14,2692,13,11411,27,normal,-
-3547142425598457141,10.0.2.16,8.8.8.8,53,udp,dns,98,152,1,96,1,248,2,normal,-
-7291357799516468188,10.0.2.16,8.8.8.8,53,udp,dns,56,207,1,114,1,321,2,normal,-
-8498629215636316365,10.0.2.16,142.251.37.110,443,udp,-,312,6984,8,1896,6,8880,14,normal,-
-7253141249947137528,10.0.2.16,8.8.8.8,53,udp,dns,58,149,1,84,1,233,2,normal,-
8491958953191006084,10.0.2.16,8.8.8.8,53,udp,dns,53,115,1,87,1,202,2,normal,-
-2219518272347109645,10.0.2.16,104.18.21.226,80,tcp,http,125332,7049,23,2632,24,9681,47,normal,-
4322499480297458687,10.0.2.16,8.8.8.8,53,udp,dns,53,124,1,86,1,210,2,normal,-
-5919367276492796614,10.0.2.16,8.8.8.8,53,udp,dns,56,164,1,100,1,264,2,normal,-
-2562579121708229533,10.0.2.16,8.8.8.8,53,udp,dns,130,125,1,93,1,218,2,normal,-
-6624235510304550619,10.0.2.16,8.8.8.8,53,udp,dns,59,143,1,85,1,228,2,normal,-
-2712077617377977762,10.0.2.16,34.107.221.82,80,tcp,http,31952,690,8,809,9,1499,17,normal,-
2335427258938738140,10.0.2.16,8.8.8.8,53,udp,dns,173,339,2,193,2,532,4,normal,-
-8966855280711061838,10.0.2.16,8.8.8.8,53,udp,dns,49,159,1,94,1,253,2,normal,-
8905893823245237952,10.0.2.16,8.8.8.8,53,udp,dns,48,207,1,114,1,321,2,normal,-
-2090074038942155008,10.0.2.16,8.8.8.8,53,udp,dns,41,164,1,111,1,275,2,normal,-
6953105324202156306,10.0.2.16,8.8.8.8,53,udp,dns,51,148,1,92,1,240,2,normal,-
-6415495243734586613,10.0.2.16,8.8.8.8,53,udp,dns,43,146,1,81,1,227,2,normal,-
3053541653341051524,10.0.2.16,65.9.9.138,80,tcp,http,143690,8452,29,4671,30,13123,59,normal,-
2156892782108857931,10.0.2.16,8.8.8.8,53,udp,dns,216,146,1,81,1,227,2,normal,-
-3173391201283425913,10.0.2.16,8.8.8.8,53,udp,dns,47,155,1,99,1,254,2,normal,-
7100432173476778075,10.0.2.16,104.19.154.83,443,udp,-,6333,9026,16,3186,9,12212,25,normal,-
-5707398080497855274,10.0.2.16,142.251.36.98,443,udp,-,8331,10163,23,5234,19,15397,42,normal,-
5527470224182046354,10.0.2.16,8.8.8.8,53,udp,dns,50,157,1,80,1,237,2,normal,-
-8186141993698116502,10.0.2.16,8.8.8.8,53,udp,dns,89,204,1,84,1,288,2,normal,-
-4211039149341834489,10.0.2.16,31.13.81.13,443,udp,-,249,5654,9,1999,7,7653,16,normal,-
-8133610334454831433,10.0.2.16,8.8.8.8,53,udp,dns,45,132,1,83,1,215,2,normal,-
-5328633278511420506,10.0.2.16,8.8.8.8,53,udp,dns,60,103,1,87,1,190,2,normal,-
496499915708472786,10.0.2.16,142.251.36.131,80,tcp,-,5761,180,3,236,4,416,7,normal,-
1513656344549100798,10.0.2.16,8.8.8.8,53,udp,dns,47,180,1,84,1,264,2,normal,-
-1267652682907378072,10.0.2.16,8.8.8.8,53,udp,dns,53,116,1,88,1,204,2,normal,-
-2395855586710902124,10.0.2.16,8.8.8.8,53,udp,dns,61,141,1,82,1,223,2,normal,-
-9134546655402118445,10.0.2.16,8.8.8.8,53,udp,dns,43,155,1,86,1,241,2,normal,-
8445832809156993228,10.0.2.16,8.8.8.8,53,udp,dns,50,174,1,92,1,266,2,normal,-
-3321883523105563338,10.0.2.16,8.8.8.8,53,udp,dns,42,158,1,94,1,252,2,normal,-
-3492184109877048377,10.0.2.16,8.8.8.8,53,udp,dns,55,135,1,84,1,219,2,normal,-
7197062734865668541,10.0.2.16,8.8.8.8,53,udp,dns,46,280,1,87,1,367,2,normal,-
-4736306931029023903,10.0.2.16,8.8.8.8,53,udp,dns,35,102,1,86,1,188,2,normal,-
-60018078426919510,10.0.2.16,8.8.8.8,53,udp,dns,66,117,1,101,1,218,2,normal,-
2317063766210865169,10.0.2.16,142.251.37.99,443,udp,-,246,2455,5,1630,3,4085,8,normal,-
210837203736782355,10.0.2.16,8.8.8.8,53,udp,dns,47,294,1,85,1,379,2,normal,-
1248033332234859699,10.0.2.16,8.8.8.8,53,udp,dns,93,177,1,84,1,261,2,normal,-
9006241953878693206,10.0.2.16,185.80.39.216,443,tcp,-,1104,60,1,128,2,188,3,normal,-
5719668281976207161,10.0.2.16,95.100.146.41,80,tcp,http,130286,6854,26,4016,27,10870,53,normal,-
-178229016297696546,10.0.2.16,104.18.21.226,80,tcp,http,99421,2823,15,1330,16,4153,31,normal,-
-1391907655678789383,10.0.2.16,8.8.8.8,53,udp,dns,37,112,1,80,1,192,2,normal,-
8833852262021418334,10.0.2.16,8.8.8.8,53,udp,dns,109,188,1,90,1,278,2,normal,-
-5611807663433351751,10.0.2.16,8.8.8.8,53,udp,dns,49,207,1,114,1,321,2,normal,-
-731179604217603862,10.0.2.16,8.8.8.8,53,udp,dns,87,206,1,94,1,300,2,normal,-
-6119261616052609615,10.0.2.16,8.8.8.8,53,udp,dns,190919,336,2,207,2,543,4,normal,-
-9010876636237409168,10.0.2.16,8.8.8.8,53,udp,dns,49,142,1,81,1,223,2,normal,-
-5663527039360806504,10.0.2.16,142.251.36.106,443,udp,-,226,7384,8,2064,8,9448,16,normal,-
-4403272743260177856,10.0.2.16,104.18.32.68,80,tcp,http,115903,2176,16,1370,17,3546,33,normal,-
997460127958440360,10.0.2.16,142.251.36.97,443,udp,-,5193,12336,16,3000,14,15336,30,normal,-
1799133370520813559,10.0.2.16,8.8.8.8,53,udp,dns,46,146,1,93,1,239,2,normal,-
-4691169486791174341,10.0.2.16,65.9.9.138,80,tcp,http,39540,2522,10,1480,11,4002,21,normal,-
-8543404802565731851,10.0.2.16,8.8.8.8,53,udp,dns,55,164,1,100,1,264,2,normal,-
590132575995841193,10.0.2.16,8.8.8.8,53,udp,dns,56,116,1,84,1,200,2,normal,-
1814647639776783279,10.0.2.16,8.8.8.8,53,udp,dns,38,132,1,83,1,215,2,normal,-
-3744318347593176863,10.0.2.16,192.229.221.95,80,tcp,http,34734,1215,8,930,9,2145,17,normal,-
-849465800196560766,10.0.2.16,8.8.8.8,53,udp,dns,48,159,1,95,1,254,2,normal,-
-2329633754979801841,10.0.2.16,8.8.8.8,53,udp,dns,53,185,1,98,1,283,2,normal,-
-8105093984845663921,10.0.2.16,142.251.37.110,443,udp,-,299,9635,10,2149,9,11784,19,normal,-
-1787191899497573224,10.0.2.16,8.8.8.8,53,udp,dns,70,257,1,89,1,346,2,normal,-
-6520076561333323459,10.0.2.16,8.8.8.8,53,udp,dns,90,100,1,84,1,184,2,normal,-
5449460222268869053,10.0.2.16,8.8.8.8,53,udp,dns,43,146,1,81,1,227,2,normal,-
7150310771294705519,10.0.2.16,8.8.8.8,53,udp,dns,53,129,1,97,1,226,2,normal,-
2572740099817517316,10.0.2.16,8.8.8.8,53,udp,dns,59,167,1,90,1,257,2,normal,-
8449228564739153358,10.0.2.16,8.8.8.8,53,udp,dns,57,148,1,92,1,240,2,normal,-
-2988745284362472547,10.0.2.16,8.8.8.8,53,udp,dns,54,108,1,80,1,188,2,normal,-
-6768890122339541354,10.0.2.16,8.8.8.8,53,udp,dns,52,145,1,88,1,233,2,normal,-
1197681545239263265,10.0.2.16,8.8.8.8,53,udp,dns,37,119,1,87,1,206,2,normal,-
1414804749167357513,10.0.2.16,8.8.8.8,53,udp,dns,103,111,1,95,1,206,2,normal,-
2686831978419942557,10.0.2.16,8.8.8.8,53,udp,dns,52,113,1,97,1,210,2,normal,-
697807799736966173,10.0.2.16,77.75.78.104,443,tcp,tls,10275,9063,16,3260,18,12323,34,normal,-
5413018577295137363,10.0.2.16,157.240.30.27,443,udp,-,165,5733,10,2203,8,7936,18,normal,-
3977438710603984391,10.0.2.16,65.9.95.112,443,tcp,-,47,60,1,128,2,188,3,normal,-
-5818270320824927134,10.0.2.16,8.8.8.8,53,udp,dns,50,174,1,93,1,267,2,normal,-
4835245079803185708,10.0.2.16,8.8.8.8,53,udp,dns,54,194,1,82,1,276,2,normal,-
-3170386488743723554,10.0.2.16,8.8.8.8,53,udp,dns,43,117,1,101,1,218,2,normal,-
2498870499847671465,10.0.2.16,8.8.8.8,53,udp,dns,53,131,1,99,1,230,2,normal,-
475313080488095168,10.0.2.16,8.8.8.8,53,udp,dns,40,178,1,97,1,275,2,normal,-
1704484646450178070,10.0.2.16,8.8.8.8,53,udp,dns,60,138,1,90,1,228,2,normal,-
9072728877758459680,10.0.2.16,8.8.8.8,53,udp,dns,51,206,1,98,1,304,2,normal,-
-7139825497591704762,10.0.2.16,8.8.8.8,53,udp,dns,39,115,1,99,1,214,2,normal,-
635530767021436541,10.0.2.16,8.8.8.8,53,udp,dns,73,156,1,83,1,239,2,normal,-
1231314379241857154,10.0.2.16,17.8.136.187,443,tcp,tls,33829,6789,21,4749,22,11538,43,normal,-
-2175960677954290154,10.0.2.16,216.239.32.36,443,udp,-,4925,7829,12,3079,12,10908,24,normal,-
659815998007333060,10.0.2.16,8.8.8.8,53,udp,dns,46,140,1,91,1,231,2,normal,-
-4460214861365617623,10.0.2.16,142.251.37.99,443,udp,-,235,8298,11,2629,11,10927,22,normal,-
4433666840291023973,10.0.2.16,8.8.8.8,53,udp,dns,51,165,1,100,1,265,2,normal,-
-4425702413450138494,10.0.2.16,31.13.66.19,443,udp,-,397,8376,13,2033,7,10409,20,normal,-
2039084922310315071,10.0.2.16,142.251.36.67,80,tcp,http,115837,1655,16,1364,17,3019,33,normal,-
-907415381975574282,10.0.2.16,8.8.8.8,53,udp,dns,187978,339,2,230,2,569,4,normal,-
5662483890183879983,10.0.2.16,8.8.8.8,53,udp,dns,151,324,1,100,1,424,2,normal,-
3707334222701112202,10.0.2.16,8.8.8.8,53,udp,dns,64,189,1,108,1,297,2,normal,-
2106129732470862749,10.0.2.16,151.101.193.16,443,tcp,-,99,60,1,128,2,188,3,normal,-
5194212103083160298,10.0.2.16,157.240.30.35,443,udp,-,127,5653,9,1824,5,7477,14,normal,-
-8010359728350380199,10.0.2.16,8.8.8.8,53,udp,dns,135,154,1,93,1,247,2,normal,-
-5083780914776694642,10.0.2.16,8.8.8.8,53,udp,dns,106,116,1,88,1,204,2,normal,-
2166717127145059320,10.0.2.16,142.251.37.99,443,udp,-,308,7019,8,1981,7,9000,15,normal,-
8682644255690367882,10.0.2.16,8.8.8.8,53,udp,dns,56,153,1,96,1,249,2,normal,-
2494885060793277926,10.0.2.16,142.251.36.78,443,udp,-,302,9732,11,2443,11,12175,22,normal,-
3900297470481959347,10.0.2.16,8.8.8.8,53,udp,dns,118,114,1,86,1,200,2,normal,-
1171377102867050072,10.0.2.16,8.8.8.8,53,udp,dns,39,189,1,87,1,276,2,normal,-
-39420586621224096,10.0.2.16,8.8.8.8,53,udp,dns,66,148,1,92,1,240,2,normal,-
-2261050754809015423,10.0.2.16,8.8.8.8,53,udp,dns,138,339,2,193,2,532,4,normal,-
8012757476727156368,10.0.2.16,8.8.8.8,53,udp,dns,48,112,1,84,1,196,2,normal,-
6791202262221407450,10.0.2.16,8.8.8.8,53,udp,dns,127569,413,2,184,2,597,4,normal,-
3269761544635462195,10.0.2.16,8.8.8.8,53,udp,dns,53,197,1,83,1,280,2,normal,-
3455832178990833984,10.0.2.16,8.8.8.8,53,udp,dns,43,233,1,101,1,334,2,normal,-
1568009622110207674,10.0.2.16,157.240.30.27,443,udp,-,165,5425,9,1974,6,7399,15,normal,-
6172477278207463098,10.0.2.16,8.8.8.8,53,udp,dns,50,136,1,86,1,222,2,normal,-
8882517841459756441,10.0.2.16,8.8.8.8,53,udp,dns,38,205,1,87,1,292,2,normal,-
2619935185806414466,10.0.2.16,8.8.8.8,53,udp,dns,51,156,1,83,1,239,2,normal,-
-7598493119830582978,10.0.2.16,8.8.8.8,53,udp,dns,96,97,1,81,1,178,2,normal,-
6377572187134407125,10.0.2.16,142.251.37.99,443,udp,-,350,7110,9,2446,11,9556,20,normal,-
996206992930868507,10.0.2.16,8.8.8.8,53,udp,dns,44,112,1,80,1,192,2,normal,-
3076600444312499060,10.0.2.16,8.8.8.8,53,udp,dns,71,177,1,84,1,261,2,normal,-
-7484610075328104665,10.0.2.16,8.8.8.8,53,udp,dns,48,150,1,94,1,244,2,normal,-
-7969137616594243408,10.0.2.16,8.8.8.8,53,udp,dns,73,104,1,88,1,192,2,normal,-
-6165694331117269387,10.0.2.16,8.8.8.8,53,udp,dns,53,135,1,91,1,226,2,normal,-
-4083377786626477103,10.0.2.16,8.8.8.8,53,udp,dns,210,100,1,84,1,184,2,normal,-
-6896183907000631098,10.0.2.16,8.8.8.8,53,udp,dns,46,176,1,111,1,287,2,normal,-
-7543081805242947145,10.0.2.16,8.8.8.8,53,udp,dns,64,164,1,98,1,262,2,normal,-
-5208014284110577739,10.0.2.16,8.8.8.8,53,udp,dns,44,273,1,104,1,377,2,normal,-
1148302645024805753,10.0.2.16,8.8.8.8,53,udp,dns,73,134,1,85,1,219,2,normal,-
-3241250526526763274,10.0.2.16,8.8.8.8,53,udp,dns,97,123,1,95,1,218,2,normal,-
-2808080076630381345,10.0.2.16,8.8.8.8,53,udp,dns,54,123,1,95,1,218,2,normal,-
-4942124535599662669,10.0.2.16,142.251.37.104,443,udp,-,149,2290,4,1628,3,3918,7,normal,-
-7058088137194327522,10.0.2.16,8.8.8.8,53,udp,dns,58,171,1,90,1,261,2,normal,-
-8681071683708702161,10.0.2.16,8.8.8.8,53,udp,dns,52,206,1,91,1,297,2,normal,-
-3070806940353562761,10.0.2.16,8.8.8.8,53,udp,dns,51,140,1,80,1,220,2,normal,-
9147430625328646090,10.0.2.16,8.8.8.8,53,udp,dns,47,137,1,85,1,222,2,normal,-
4248208361347206922,10.0.2.16,8.8.8.8,53,udp,dns,96,114,1,98,1,212,2,normal,-
-4274125894596711971,10.0.2.16,8.8.8.8,53,udp,dns,73,117,1,85,1,202,2,normal,-
-344078940898789981,10.0.2.16,8.8.8.8,53,udp,dns,82,137,1,88,1,225,2,normal,-
6891144534136478957,10.0.2.16,142.251.36.142,443,udp,-,201,9636,10,2153,9,11789,19,normal,-
-8231299038628092923,10.0.2.16,8.8.8.8,53,udp,dns,54,214,1,94,1,308,2,normal,-
7634190889586365882,10.0.2.16,8.8.8.8,53,udp,dns,48,101,1,85,1,186,2,normal,-
-3265598226880436139,10.0.2.16,8.8.8.8,53,udp,dns,64,258,1,87,1,345,2,normal,-
5199737412062236150,10.0.2.16,8.8.8.8,53,udp,dns,59,210,1,90,1,300,2,normal,-
1686492487850448932,10.0.2.16,8.8.8.8,53,udp,dns,51,114,1,98,1,212,2,normal,-
1514299888649117022,10.0.2.16,8.8.8.8,53,udp,dns,64,121,1,105,1,226,2,normal,-
6273657793136630090,10.0.2.16,8.8.8.8,53,udp,dns,59,218,1,91,1,309,2,normal,-
6112513150418848345,10.0.2.16,77.75.78.229,443,tcp,-,1062,60,1,128,2,188,3,normal,-
4230301443765729912,10.0.2.16,8.8.8.8,53,udp,dns,42,170,1,88,1,258,2,normal,-
1018277084106152749,10.0.2.16,8.8.8.8,53,udp,dns,64,114,1,98,1,212,2,normal,-
-7787026087990205569,10.0.2.16,8.8.8.8,53,udp,dns,47,141,1,84,1,225,2,normal,-
-2147846521969476976,10.0.2.16,8.8.8.8,53,udp,dns,51,323,1,85,1,408,2,normal,-
-4920486721167496389,10.0.2.16,8.8.8.8,53,udp,dns,52,207,1,114,1,321,2,normal,-
7033174970611782550,10.0.2.16,8.8.8.8,53,udp,dns,42,141,1,82,1,223,2,normal,-
-7008735888935677249,10.0.2.16,142.251.37.98,443,udp,-,8127,10907,18,3743,18,14650,36,normal,-
-699244731691505811,10.0.2.16,142.251.37.99,80,tcp,http,6200,1388,5,689,6,2077,11,normal,-
4936425594732352700,10.0.2.16,8.8.8.8,53,udp,dns,40,112,1,84,1,196,2,normal,-
4719000866861021260,10.0.2.16,8.8.8.8,53,udp,dns,56,149,1,87,1,236,2,normal,-
643151333455329405,10.0.2.16,8.8.8.8,53,udp,dns,42,170,1,88,1,258,2,normal,-
3861693819848042643,10.0.2.16,8.8.8.8,53,udp,dns,63,117,1,87,1,204,2,normal,-
-104750830611565858,10.0.2.16,8.8.8.8,53,udp,dns,41,116,1,84,1,200,2,normal,-
-5763015669764402203,10.0.2.16,8.8.8.8,53,udp,dns,54,133,1,77,1,210,2,normal,-
2107163307803045254,10.0.2.16,8.8.8.8,53,udp,dns,51,324,1,83,1,407,2,normal,-
4609724351084355277,10.0.2.16,8.8.8.8,53,udp,dns,49,148,1,92,1,240,2,normal,-
4780816528444981738,10.0.2.16,8.8.8.8,53,udp,dns,51,101,1,85,1,186,2,normal,-
1012401333260085330,10.0.2.16,8.8.8.8,53,udp,dns,43,153,1,89,1,242,2,normal,-
-3379446003819990810,10.0.2.16,8.8.8.8,53,udp,dns,140,199,1,92,1,291,2,normal,-
-6659199303693436623,10.0.2.16,8.8.8.8,53,udp,dns,163,107,1,91,1,198,2,normal,-
3298819366702766862,10.0.2.16,8.8.8.8,53,udp,dns,59,189,1,118,1,307,2,normal,-
-2057361595115233811,10.0.2.16,142.251.36.78,443,udp,-,226,9745,11,2615,13,12360,24,normal,-
-8432256295404624146,10.0.2.16,142.251.36.142,443,udp,-,322,9732,11,2365,10,12097,21,normal,-
-7509981005271799645,10.0.2.16,64.4.250.37,443,tcp,tls,30361,5470,17,2269,16,7739,33,normal,-
-3074687721992744212,10.0.2.16,65.9.95.112,443,tcp,-,40,60,1,128,2,188,3,normal,-
-7756367299383894703,10.0.2.16,8.8.8.8,53,udp,dns,50,144,1,87,1,231,2,normal,-
4159179008190618243,10.0.2.16,8.8.8.8,53,udp,dns,210,112,1,84,1,196,2,normal,-
-7232108775141685665,10.0.2.16,8.8.8.8,53,udp,dns,64,133,1,93,1,226,2,normal,-
-3986795285087819926,10.0.2.16,142.251.36.86,443,udp,-,10415,871188,668,22677,198,893865,866,normal,-
-7198838078693737119,10.0.2.16,157.240.30.63,443,udp,-,2399,17400,26,3075,13,20475,39,normal,-
-5631808687164782070,10.0.2.16,142.251.36.98,443,udp,-,257,8017,11,2547,10,10564,21,normal,-
-2392996902800273623,10.0.2.16,8.8.8.8,53,udp,dns,59,94,1,78,1,172,2,normal,-
7296412581647387046,10.0.2.16,142.251.36.131,443,udp,-,264,6987,8,2151,9,9138,17,normal,-
7099960152512056653,10.0.2.16,8.8.8.8,53,udp,dns,43,143,1,86,1,229,2,normal,-
3236755661478064087,10.0.2.16,8.8.8.8,53,udp,dns,59,142,1,86,1,228,2,normal,-
-4532419386367900878,10.0.2.16,8.8.8.8,53,udp,dns,71,211,1,93,1,304,2,normal,-
-151263739607068034,10.0.2.16,8.8.8.8,53,udp,dns,59,172,1,106,1,278,2,normal,-
-8613975870340110512,10.0.2.16,8.8.8.8,53,udp,dns,46,111,1,95,1,206,2,normal,-
1817151807618184888,10.0.2.16,8.8.8.8,53,udp,dns,7821,287,2,163,2,450,4,normal,-
7691768612678961342,10.0.2.16,204.79.197.203,80,tcp,http,70058,2919,11,1049,11,3968,22,normal,-
6009782625637572820,10.0.2.16,8.8.8.8,53,udp,dns,86,233,1,101,1,334,2,normal,-
6450456921063774330,10.0.2.16,8.8.8.8,53,udp,dns,43,133,1,93,1,226,2,normal,-
1762842083084202072,10.0.2.16,8.8.8.8,53,udp,dns,61,177,1,89,1,266,2,normal,-
-2177102196578897633,10.0.2.16,8.8.8.8,53,udp,dns,61,148,1,92,1,240,2,normal,-
113797090750946813,10.0.2.16,8.8.8.8,53,udp,dns,61,128,1,100,1,228,2,normal,-
-150402372341823431,10.0.2.16,8.8.8.8,53,udp,dns,132,158,1,89,1,247,2,normal,-
7265583265668678613,10.0.2.16,8.8.8.8,53,udp,dns,57,131,1,99,1,230,2,normal,-
-2733320213123311171,10.0.2.16,104.17.50.95,443,udp,-,39918,668789,693,118705,346,787494,1039,normal,-
7162637181361261734,10.0.2.16,8.8.8.8,53,udp,dns,96,146,1,81,1,227,2,normal,-
-8542984747969451637,10.0.2.16,192.229.221.95,80,tcp,-,6034,180,3,236,4,416,7,normal,-
2240845282316847448,10.0.2.16,8.8.8.8,53,udp,dns,47,135,1,84,1,219,2,normal,-
-4193716028247060214,10.0.2.16,8.8.8.8,53,udp,dns,40,111,1,83,1,194,2,normal,-
-2589580037203039079,10.0.2.16,8.8.8.8,53,udp,dns,68,113,1,97,1,210,2,normal,-
2436368719292444286,10.0.2.16,8.8.8.8,53,udp,dns,48,140,1,84,1,224,2,normal,-
2643848239263427606,10.0.2.16,8.8.8.8,53,udp,dns,37,113,1,85,1,198,2,normal,-
2690085902813334781,10.0.2.16,8.8.8.8,53,udp,dns,90,152,1,88,1,240,2,normal,-
-2900829480962843128,10.0.2.16,8.8.8.8,53,udp,dns,48,220,1,99,1,319,2,normal,-
4050617831050123005,10.0.2.16,8.8.8.8,53,udp,dns,51,193,1,90,1,283,2,normal,-
304625392652024085,10.0.2.16,8.8.8.8,53,udp,dns,216,141,1,82,1,223,2,normal,-
5449457308410832747,10.0.2.16,142.251.36.100,443,udp,-,133,2290,4,1629,3,3919,7,normal,-
-8655344010725321161,10.0.2.16,8.8.8.8,53,udp,dns,59,146,1,81,1,227,2,normal,-
530922247617846991,10.0.2.16,8.8.8.8,53,udp,dns,48,236,1,96,1,332,2,normal,-
1077265450467946212,10.0.2.16,8.8.8.8,53,udp,dns,55,138,1,82,1,220,2,normal,-
5140702331978219850,10.0.2.16,8.8.8.8,53,udp,dns,62,145,1,94,1,239,2,normal,-
1127855123826055924,10.0.2.16,8.8.8.8,53,udp,dns,58,116,1,88,1,204,2,normal,-
8635156199692809673,10.0.2.16,8.8.8.8,53,udp,dns,90,200,1,91,1,291,2,normal,-
-4812071572656075009,10.0.2.16,8.8.8.8,53,udp,dns,64,180,1,85,1,265,2,normal,-
8153042818992346765,10.0.2.16,8.8.8.8,53,udp,dns,54,162,1,82,1,244,2,normal,-
-6412842028593449932,10.0.2.16,8.8.8.8,53,udp,dns,45,130,1,114,1,244,2,normal,-
-5537193417102334580,10.0.2.16,8.8.8.8,53,udp,dns,116,339,2,193,2,532,4,normal,-
-4706054288496422181,10.0.2.16,34.160.236.64,443,udp,-,299,4863,6,1816,5,6679,11,normal,-
-8316902478830417125,10.0.2.16,8.8.8.8,53,udp,dns,44,244,1,100,1,344,2,normal,-
8678854427838391597,10.0.2.16,8.8.8.8,53,udp,dns,52,151,1,91,1,242,2,normal,-
-8775102806073866893,10.0.2.16,8.8.8.8,53,udp,dns,90,112,1,96,1,208,2,normal,-
-1165321772682177145,10.0.2.16,8.8.8.8,53,udp,dns,94,187,1,83,1,270,2,normal,-
-2708966655022701432,10.0.2.16,8.8.8.8,53,udp,dns,39,214,1,130,1,344,2,normal,-
-1067308772915202681,10.0.2.16,8.8.8.8,53,udp,dns,71,144,1,88,1,232,2,normal,-
3502138024949798768,10.0.2.16,192.124.249.41,80,tcp,http,38697,2816,9,976,10,3792,19,normal,-
5359631971214812117,10.0.2.16,8.8.8.8,53,udp,dns,41,156,1,83,1,239,2,normal,-
8283605451582531398,10.0.2.16,8.8.8.8,53,udp,dns,58,136,1,89,1,225,2,normal,-
-5985672667485194409,10.0.2.16,8.8.8.8,53,udp,dns,48,106,1,78,1,184,2,normal,-
9028582247393462934,10.0.2.16,8.8.8.8,53,udp,dns,70,307,1,101,1,408,2,normal,-
8751644577401254262,10.0.2.16,8.8.8.8,53,udp,dns,145,143,1,75,1,218,2,normal,-
-8520499145003037172,10.0.2.16,8.8.8.8,53,udp,dns,50,207,1,114,1,321,2,normal,-
9111530380934492374,10.0.2.16,8.8.8.8,53,udp,dns,51,118,1,90,1,208,2,normal,-
734985040572947918,10.0.2.16,8.8.8.8,53,udp,dns,47,118,1,90,1,208,2,normal,-
5673525925480104396,10.0.2.16,17.253.73.201,80,tcp,http,115469,2507,17,1379,17,3886,34,normal,-
1282428665263752588,10.0.2.16,8.8.8.8,53,udp,dns,59,115,1,99,1,214,2,normal,-
-3809663820552146737,10.0.2.16,8.8.8.8,53,udp,dns,56,170,1,88,1,258,2,normal,-
-6860897417967044675,10.0.2.16,142.251.36.99,443,udp,-,16972,472561,409,22651,149,495212,558,normal,-
6927767553310724743,10.0.2.16,8.8.8.8,53,udp,dns,59,148,1,92,1,240,2,normal,-
6423975239846757442,10.0.2.16,142.251.36.100,443,udp,-,36489,25326,99,9771,81,35097,180,normal,-
-7521336009661375877,10.0.2.16,8.8.8.8,53,udp,dns,69,174,1,93,1,267,2,normal,-
-992160217392647021,10.0.2.16,192.124.249.41,80,tcp,http,36491,2815,9,975,10,3790,19,normal,-
-8792123246105404677,10.0.2.16,8.8.8.8,53,udp,dns,124,146,1,89,1,235,2,normal,-
-4773371234844606982,10.0.2.16,8.8.8.8,53,udp,dns,64,135,1,87,1,222,2,normal,-
5463564697626123015,10.0.2.16,8.8.8.8,53,udp,dns,119,135,1,84,1,219,2,normal,-
-3402911124379404980,10.0.2.16,142.251.36.78,443,udp,-,284,9744,11,2445,11,12189,22,normal,-
-8639526270312854131,10.0.2.16,13.107.21.200,443,tcp,-,449,60,1,128,2,188,3,normal,-
8486553526567725497,10.0.2.16,8.8.8.8,53,udp,dns,5066,169,1,178,2,347,3,normal,-
-3835368721885051955,10.0.2.16,8.8.8.8,53,udp,dns,47,106,1,90,1,196,2,normal,-
6519252697312379403,10.0.2.16,8.8.8.8,53,udp,dns,51,125,1,90,1,215,2,normal,-
6086225246817712948,10.0.2.16,8.8.8.8,53,udp,dns,51,237,1,90,1,327,2,normal,-
-6893792518085431045,10.0.2.16,8.8.8.8,53,udp,dns,45,140,1,84,1,224,2,normal,-
-2647326241732718856,10.0.2.16,8.8.8.8,53,udp,dns,79,148,1,92,1,240,2,normal,-
5368290154018537360,10.0.2.16,8.8.8.8,53,udp,dns,45,166,1,82,1,248,2,normal,-
-7136312083398271046,10.0.2.16,8.8.8.8,53,udp,dns,50,144,1,88,1,232,2,normal,-
-7069237873467207611,10.0.2.16,8.8.8.8,53,udp,dns,45,207,1,114,1,321,2,normal,-
582626638945863531,10.0.2.16,8.8.8.8,53,udp,dns,51,116,1,84,1,200,2,normal,-
3941540336028520580,10.0.2.16,8.8.8.8,53,udp,dns,93,154,1,93,1,247,2,normal,-
5513592189028006475,10.0.2.16,8.8.8.8,53,udp,dns,58,130,1,102,1,232,2,normal,-
-1921473415050683393,10.0.2.16,8.8.8.8,53,udp,dns,39,152,1,88,1,240,2,normal,-
4595059620952073049,10.0.2.16,104.17.50.95,443,udp,-,22630,9966,20,5626,18,15592,38,normal,-
-6069514867217315069,10.0.2.16,157.240.30.27,443,udp,-,116,2296,7,1680,4,3976,11,normal,-
-2733671299068855994,10.0.2.16,8.8.8.8,53,udp,dns,103,339,2,193,2,532,4,normal,-
-2471295932744240256,10.0.2.16,8.8.8.8,53,udp,dns,57,181,1,97,1,278,2,normal,-
-1940493003374244495,10.0.2.16,142.251.37.110,443,udp,-,383,11628,14,2768,12,14396,26,normal,-
-4879769236330422078,10.0.2.16,142.251.37.110,443,udp,-,171,7331,8,2064,8,9395,16,normal,-
-7020178221759053349,10.0.2.16,8.8.8.8,53,udp,dns,44,132,1,83,1,215,2,normal,-
-2241132997973470388,10.0.2.16,8.8.8.8,53,udp,dns,177748,418,2,180,2,598,4,normal,-
-5861678352726772158,10.0.2.16,8.8.8.8,53,udp,dns,40,99,1,83,1,182,2,normal,-
-134632324757936681,10.0.2.16,8.8.8.8,53,udp,dns,141,114,1,86,1,200,2,normal,-
-8679306114330452274,10.0.2.16,8.8.8.8,53,udp,dns,91,99,1,83,1,182,2,normal,-
-9069863834386255063,10.0.2.16,8.8.8.8,53,udp,dns,41,167,1,83,1,250,2,normal,-
4508006764483656656,10.0.2.16,8.8.8.8,53,udp,dns,162,339,2,193,2,532,4,normal,-
5265583124286581327,10.0.2.16,8.8.8.8,53,udp,dns,234,177,1,84,1,261,2,normal,-
7152178778541773645,10.0.2.16,162.159.136.232,443,udp,-,6627,4509542,3766,155703,1234,4665245,5000,normal,-
7312215001488401943,10.0.2.16,8.8.8.8,53,udp,dns,46,155,1,99,1,254,2,normal,-
-8651646731199923839,10.0.2.16,8.8.8.8,53,udp,dns,73,103,1,75,1,178,2,normal,-
-7936956255163015228,10.0.2.16,8.8.8.8,53,udp,dns,64,176,1,92,1,268,2,normal,-
5754392898684819426,10.0.2.16,8.8.8.8,53,udp,dns,39,134,1,89,1,223,2,normal,-
494099074565090863,10.0.2.16,142.251.36.132,443,udp,-,32121,15541,40,4990,34,20531,74,normal,-
2016558098392144999,10.0.2.16,8.8.8.8,53,udp,dns,97,126,1,98,1,224,2,normal,-
3911397015656213129,10.0.2.16,8.8.8.8,53,udp,dns,63,198,1,117,1,315,2,normal,-
8620115273330287999,10.0.2.16,8.8.8.8,53,udp,dns,45,132,1,87,1,219,2,normal,-
-2142601779367421876,10.0.2.16,142.251.36.142,443,udp,-,317,11132,12,2307,9,13439,21,normal,-
2954111040919337636,10.0.2.16,8.8.8.8,53,udp,dns,60,119,1,91,1,210,2,normal,-
6905491993365948681,10.0.2.16,8.8.8.8,53,udp,dns,48,94,1,78,1,172,2,normal,-
1021722433570517823,10.0.2.16,104.18.32.68,80,tcp,http,115916,2176,16,1370,17,3546,33,normal,-
5327514850214769819,10.0.2.16,192.124.249.41,80,tcp,http,64909,2996,12,1084,12,4080,24,normal,-
3131819418046896884,10.0.2.16,8.8.8.8,53,udp,dns,51,149,1,93,1,242,2,normal,-
6928304624982256372,10.0.2.16,8.8.8.8,53,udp,dns,48,112,1,96,1,208,2,normal,-
-8986418717799508680,10.0.2.16,142.251.36.78,443,udp,-,25102,23616,33,4353,21,27969,54,normal,-
1979593109483412941,10.0.2.16,8.8.8.8,53,udp,dns,41,145,1,84,1,229,2,normal,-
6890210423595763455,10.0.2.16,35.167.180.67,443,tcp,-,213,60,1,128,2,188,3,normal,-
1879653588173412067,10.0.2.16,8.8.8.8,53,udp,dns,53,113,1,97,1,210,2,normal,-
-605175618418061154,10.0.2.16,8.8.8.8,53,udp,dns,88,135,1,84,1,219,2,normal,-
980930518840052396,10.0.2.16,8.8.8.8,53,udp,dns,106,104,1,88,1,192,2,normal,-
8723697265904013701,10.0.2.16,54.239.28.85,80,tcp,-,5494,180,3,236,4,416,7,normal,-
-1694971091315368667,10.0.2.16,8.8.8.8,53,udp,dns,33,119,1,87,1,206,2,normal,-
-4001640426229099863,10.0.2.16,8.8.8.8,53,udp,dns,88,174,1,90,1,264,2,normal,-
553282016250942385,10.0.2.16,142.251.37.104,443,udp,-,271,7339,8,2065,8,9404,16,normal,-
-7445717396663398629,10.0.2.16,8.8.8.8,53,udp,dns,56,143,1,86,1,229,2,normal,-
3564247327502255364,10.0.2.16,8.8.8.8,53,udp,dns,51,108,1,92,1,200,2,normal,-
3066193248480642420,10.0.2.16,8.8.8.8,53,udp,dns,46,189,1,91,1,280,2,normal,-
-8508441009176845847,10.0.2.16,8.8.8.8,53,udp,dns,60,191,1,86,1,277,2,normal,-
1050635544289072477,10.0.2.16,8.8.8.8,53,udp,dns,49,150,1,89,1,239,2,normal,-
4973654501387179467,10.0.2.16,8.8.8.8,53,udp,dns,57,220,1,87,1,307,2,normal,-
-2047546668205549328,10.0.2.16,34.107.204.85,443,udp,-,164,6784,6,1900,6,8684,12,normal,-
-1735953634952037564,10.0.2.16,8.8.8.8,53,udp,dns,41,104,1,88,1,192,2,normal,-
6541322788487663645,10.0.2.16,8.8.8.8,53,udp,dns,71,251,1,88,1,339,2,normal,-
-2436370835352142573,10.0.2.16,8.8.8.8,53,udp,dns,54,149,1,92,1,241,2,normal,-
-2492752700295022192,10.0.2.16,8.8.8.8,53,udp,dns,53,118,1,90,1,208,2,normal,-
5797527776661227530,10.0.2.16,8.8.8.8,53,udp,dns,50,270,1,85,1,355,2,normal,-
-7596925402994449081,10.0.2.16,8.8.8.8,53,udp,dns,76,140,1,84,1,224,2,normal,-
-7077972308223903531,10.0.2.16,8.8.8.8,53,udp,dns,53,336,1,81,1,417,2,normal,-
-3146862460469116845,10.0.2.16,8.8.8.8,53,udp,dns,55,223,1,90,1,313,2,normal,-
-4832364699172554528,10.0.2.16,142.251.36.141,443,udp,-,231,10783,14,2808,12,13591,26,normal,-
6073852123028933896,10.0.2.16,8.8.8.8,53,udp,dns,51,148,1,92,1,240,2,normal,-
-1964528099096249093,10.0.2.16,8.8.8.8,53,udp,dns,68,148,1,92,1,240,2,normal,-
-3257915191078766929,10.0.2.16,8.8.8.8,53,udp,dns,59,155,1,99,1,254,2,normal,-
-2427889751300108878,10.0.2.16,8.8.8.8,53,udp,dns,46,130,1,82,1,212,2,normal,-
-3865073966926835002,10.0.2.16,8.8.8.8,53,udp,dns,54,156,1,83,1,239,2,normal,-
-4532595635472488654,10.0.2.16,8.8.8.8,53,udp,dns,88,132,1,83,1,215,2,normal,-
-5452627593269842757,10.0.2.16,8.8.8.8,53,udp,dns,35,178,1,97,1,275,2,normal,-
6486028679528714283,10.0.2.16,142.251.37.99,443,tcp,-,165,60,1,128,2,188,3,normal,-
3696283482769239338,10.0.2.16,8.8.8.8,53,udp,dns,46,130,1,82,1,212,2,normal,-
3630177112531905101,10.0.2.16,8.8.8.8,53,udp,dns,69,324,1,100,1,424,2,normal,-
1290549776395946202,10.0.2.16,8.8.8.8,53,udp,dns,40,146,1,81,1,227,2,normal,-
4550624374009307826,10.0.2.16,8.8.8.8,53,udp,dns,21039,220,2,188,2,408,4,normal,-
-614684127302045404,10.0.2.16,142.251.36.67,80,tcp,http,129564,8205,32,5670,33,13875,65,normal,-
-7561314186631084697,10.0.2.16,8.8.8.8,53,udp,dns,49,263,1,116,1,379,2,normal,-
4640191967050375702,10.0.2.16,8.8.8.8,53,udp,dns,49,117,1,85,1,202,2,normal,-
-8115343853716717807,10.0.2.16,8.8.8.8,53,udp,dns,73,218,1,88,1,306,2,normal,-
953076676511293844,10.0.2.16,142.251.36.134,443,udp,-,307,7218,8,1980,7,9198,15,normal,-
-1892305241680431975,10.0.2.16,8.8.8.8,53,udp,dns,55,161,1,88,1,249,2,normal,-
3447763859764548118,10.0.2.16,142.251.37.104,443,udp,-,361,7502,10,2235,10,9737,20,normal,-
-8369384164618373708,10.0.2.16,8.8.8.8,53,udp,dns,61,102,1,86,1,188,2,normal,-
6193137575484031582,10.0.2.16,8.8.8.8,53,udp,dns,48,272,1,106,1,378,2,normal,-
9087468280177744162,10.0.2.16,8.8.8.8,53,udp,dns,49,166,1,92,1,258,2,normal,-
6424427724137156138,10.0.2.16,8.8.8.8,53,udp,dns,48,239,1,91,1,330,2,normal,-
-1360613940010447997,10.0.2.16,8.8.8.8,53,udp,dns,69,112,1,96,1,208,2,normal,-
-2601343097100421474,10.0.2.16,8.8.8.8,53,udp,dns,53,114,1,86,1,200,2,normal,-
6783452160405149647,10.0.2.16,8.8.8.8,53,udp,dns,138,180,1,99,1,279,2,normal,-
3820277797527661589,10.0.2.16,8.8.8.8,53,udp,dns,45,218,1,95,1,313,2,normal,-
-2718717952358805289,10.0.2.16,8.8.8.8,53,udp,dns,64,192,1,95,1,287,2,normal,-
-4062780294820781689,10.0.2.16,8.8.8.8,53,udp,dns,56,324,1,100,1,424,2,normal,-
-1303525725496679084,10.0.2.16,8.8.8.8,53,udp,dns,49,110,1,94,1,204,2,normal,-
-1429196940181234415,10.0.2.16,8.8.8.8,53,udp,dns,44,180,1,99,1,279,2,normal,-
7333375843463271177,10.0.2.16,8.8.8.8,53,udp,dns,223,226,1,90,1,316,2,normal,-
8301069014032003310,10.0.2.16,8.8.8.8,53,udp,dns,45,325,1,87,1,412,2,normal,-
-6533906714552192933,10.0.2.16,8.8.8.8,53,udp,dns,47,129,1,81,1,210,2,normal,-
-8441783271138778602,10.0.2.16,8.8.8.8,53,udp,dns,66,142,1,86,1,228,2,normal,-
8903414043485347485,10.0.2.16,151.101.0.81,443,udp,-,215,5482,6,1872,5,7354,11,normal,-
2676820023070849640,10.0.2.16,8.8.8.8,53,udp,dns,43,116,1,84,1,200,2,normal,-
8315462517420046604,10.0.2.16,8.8.8.8,53,udp,dns,46,161,1,84,1,245,2,normal,-
-7787816510366399423,10.0.2.16,8.8.8.8,53,udp,dns,85,156,1,83,1,239,2,normal,-
9219116411072931579,10.0.2.16,8.8.8.8,53,udp,dns,47,138,1,90,1,228,2,normal,-
-6153510920452428646,10.0.2.16,8.8.8.8,53,udp,dns,63,210,1,132,1,342,2,normal,-
4637405337652411926,10.0.2.16,8.8.8.8,53,udp,dns,73,151,1,97,1,248,2,normal,-
-7152262258961207728,10.0.2.16,8.8.8.8,53,udp,dns,48,170,1,88,1,258,2,normal,-
-2778793076435908773,10.0.2.16,8.8.8.8,53,udp,dns,44,166,1,96,1,262,2,normal,-
6586007658737139588,10.0.2.16,8.8.8.8,53,udp,dns,47,135,1,84,1,219,2,normal,-
-5801405384976326432,10.0.2.16,95.100.146.66,80,tcp,http,205887,15232,48,8534,48,23766,96,normal,-
4218278985265665694,10.0.2.16,8.8.8.8,53,udp,dns,48,307,1,101,1,408,2,normal,-
-7838406183724509135,10.0.2.16,8.8.8.8,53,udp,dns,78,91,1,75,1,166,2,normal,-
-6710275772673456214,10.0.2.16,142.251.37.99,443,udp,-,315,7166,10,2147,9,9313,19,normal,-
-2911201409231776126,10.0.2.16,8.8.8.8,53,udp,dns,161191,342,2,198,2,540,4,normal,-
-7178589472983896703,10.0.2.16,8.8.8.8,53,udp,dns,73,132,1,83,1,215,2,normal,-
8293977379851464396,10.0.2.16,8.8.8.8,53,udp,dns,53,126,1,86,1,212,2,normal,-
3564523741160797933,10.0.2.16,8.8.8.8,53,udp,dns,40,193,1,88,1,281,2,normal,-
-8074290112760315752,10.0.2.16,104.18.32.68,80,tcp,http,115873,1729,16,1362,17,3091,33,normal,-
-1200009152412520580,10.0.2.16,8.8.8.8,53,udp,dns,55,177,1,93,1,270,2,normal,-
5434720819849584571,10.0.2.16,8.8.8.8,53,udp,dns,48,170,1,90,1,260,2,normal,-
8817800921093916985,10.0.2.16,8.8.8.8,53,udp,dns,44,190,1,85,1,275,2,normal,-
8730843708346225109,10.0.2.16,8.8.8.8,53,udp,dns,42,136,1,80,1,216,2,normal,-
-3350556444021351692,10.0.2.16,23.195.249.173,443,tcp,-,41,60,1,128,2,188,3,normal,-
-4294573415795461800,10.0.2.16,8.8.8.8,53,udp,dns,84,363,1,91,1,454,2,normal,-
-7017786832843853296,10.0.2.16,8.8.8.8,53,udp,dns,41,111,1,95,1,206,2,normal,-
-3105669568377884098,10.0.2.16,8.8.8.8,53,udp,dns,82,113,1,85,1,198,2,normal,-
-632066182609923949,10.0.2.16,8.8.8.8,53,udp,dns,57,108,1,80,1,188,2,normal,-
-6611711247695878414,10.0.2.16,8.8.8.8,53,udp,dns,48,185,1,90,1,275,2,normal,-
9213085164912700826,10.0.2.16,8.8.8.8,53,udp,dns,173,175,1,93,1,268,2,normal,-
955163148139370832,10.0.2.16,8.8.8.8,53,udp,dns,63,258,1,84,1,342,2,normal,-
3523767756187142022,10.0.2.16,8.8.8.8,53,udp,dns,42,216,1,88,1,304,2,normal,-
7647815574035743536,10.0.2.16,8.8.8.8,53,udp,dns,54,173,1,77,1,250,2,normal,-
-3787317315718319926,10.0.2.16,8.8.8.8,53,udp,dns,54,148,1,92,1,240,2,normal,-
-4543793253680539148,10.0.2.16,8.8.8.8,53,udp,dns,180,141,1,90,1,231,2,normal,-
5410965994762915017,10.0.2.16,192.229.221.95,80,tcp,http,330494,25430,81,15896,82,41326,163,normal,-
-7643321879038545221,10.0.2.16,34.98.64.218,443,udp,-,133,4546,6,1821,5,6367,11,normal,-
-4173831857217484205,10.0.2.16,8.8.8.8,53,udp,dns,77,152,1,92,1,244,2,normal,-
-7131461922331403998,10.0.2.16,142.251.36.78,443,udp,-,307,9731,11,2284,9,12015,20,normal,-
-633815195638055346,10.0.2.16,8.8.8.8,53,udp,dns,57,110,1,82,1,192,2,normal,-
-3664162764787614064,10.0.2.16,8.8.8.8,53,udp,dns,65,362,1,95,1,457,2,normal,-
1923569639484222370,10.0.2.16,8.8.8.8,53,udp,dns,48,145,1,93,1,238,2,normal,-
-6029517773906953963,10.0.2.16,8.8.8.8,53,udp,dns,40,178,1,97,1,275,2,normal,-
-6631984443907860854,10.0.2.16,8.8.8.8,53,udp,dns,45,154,1,93,1,247,2,normal,-
-8641563830961780173,10.0.2.16,8.8.8.8,53,udp,dns,78,191,1,85,1,276,2,normal,-
-5784761465345973471,10.0.2.16,8.8.8.8,53,udp,dns,44,146,1,81,1,227,2,normal,-
6746487171496417589,10.0.2.16,8.8.8.8,53,udp,dns,107,183,1,83,1,266,2,normal,-
-3178068674898288992,10.0.2.16,8.8.8.8,53,udp,dns,49,198,1,120,1,318,2,normal,-
-8612875448499405063,10.0.2.16,8.8.8.8,53,udp,dns,203,339,2,193,2,532,4,normal,-
-584729265432258893,10.0.2.16,8.8.8.8,53,udp,dns,47,98,1,82,1,180,2,normal,-
-6269107710420114714,10.0.2.16,8.8.8.8,53,udp,dns,51,141,1,84,1,225,2,normal,-
4563535737682566075,10.0.2.16,8.8.8.8,53,udp,dns,49,121,1,89,1,210,2,normal,-
3463044040922612590,10.0.2.16,8.8.8.8,53,udp,dns,48,135,1,90,1,225,2,normal,-
4158050016112030570,10.0.2.16,142.251.37.104,443,udp,-,163,7349,8,1986,7,9335,15,normal,-
-2276462849543815651,10.0.2.16,34.107.221.82,80,tcp,http,175828,1800,23,1922,24,3722,47,normal,-
-7858147355352369670,10.0.2.16,8.8.8.8,53,udp,dns,53,109,1,93,1,202,2,normal,-
4504286713307783552,10.0.2.16,8.8.8.8,53,udp,dns,66,207,1,114,1,321,2,normal,-
-8105833292713029412,10.0.2.16,8.8.8.8,53,udp,dns,50,112,1,96,1,208,2,normal,-
6131947733437021270,10.0.2.16,8.8.8.8,53,udp,dns,80,138,1,90,1,228,2,normal,-
4379436141474935993,10.0.2.16,8.8.8.8,53,udp,dns,50,148,1,92,1,240,2,normal,-
3391150526187918170,10.0.2.16,8.8.8.8,53,udp,dns,58,166,1,100,1,266,2,normal,-
-1513295469018297790,10.0.2.16,8.8.8.8,53,udp,dns,58,138,1,86,1,224,2,normal,-
8754462663525185667,10.0.2.16,142.251.36.142,443,udp,-,216,9727,11,2364,10,12091,21,normal,-
2219830468971052072,10.0.2.16,8.8.8.8,53,udp,dns,68,187,1,84,1,271,2,normal,-
4000914635241952519,10.0.2.16,8.8.8.8,53,udp,dns,37,154,1,89,1,243,2,normal,-
-8094062235606446441,10.0.2.16,54.239.28.85,80,tcp,-,5495,180,3,236,4,416,7,normal,-
-2939046030532173788,10.0.2.16,8.8.8.8,53,udp,dns,116,108,1,92,1,200,2,normal,-
-3039477957122297733,10.0.2.16,8.8.8.8,53,udp,dns,100,201,1,90,1,291,2,normal,-
4319783795788545660,10.0.2.16,8.8.8.8,53,udp,dns,38,200,1,107,1,307,2,normal,-
-6881205450005885770,10.0.2.16,8.8.8.8,53,udp,dns,66,100,1,84,1,184,2,normal,-
-1275773794039571686,10.0.2.16,8.8.8.8,53,udp,dns,59,178,1,98,1,276,2,normal,-
-1407564924336474577,10.0.2.16,8.8.8.8,53,udp,dns,38,136,1,91,1,227,2,normal,-
-8534746619762006608,10.0.2.16,8.8.8.8,53,udp,dns,69,164,1,98,1,262,2,normal,-
-3650949877171118623,10.0.2.16,8.8.8.8,53,udp,dns,39,157,1,92,1,249,2,normal,-
3807951387461105374,10.0.2.16,8.8.8.8,53,udp,dns,43,115,1,83,1,198,2,normal,-
-8246553909281380820,10.0.2.16,8.8.8.8,53,udp,dns,43,208,1,92,1,300,2,normal,-
4125219581468692316,10.0.2.16,8.8.8.8,53,udp,dns,45,166,1,86,1,252,2,normal,-
-3428406659187137847,10.0.2.16,8.8.8.8,53,udp,dns,54,141,1,85,1,226,2,normal,-
-1284756272437009903,10.0.2.16,8.8.8.8,53,udp,dns,75252,280,2,175,2,455,4,normal,-
-4315218789536327619,10.0.2.16,8.8.8.8,53,udp,dns,49,159,1,94,1,253,2,normal,-
2135731940133988697,10.0.2.16,8.8.8.8,53,udp,dns,90,110,1,78,1,188,2,normal,-
-9015697109253987721,10.0.2.16,8.8.8.8,53,udp,dns,107,411,2,181,2,592,4,normal,-
1341415863412598483,10.0.2.16,8.8.8.8,53,udp,dns,61,101,1,85,1,186,2,normal,-
1189608316042240056,10.0.2.16,8.8.8.8,53,udp,dns,53,193,1,87,1,280,2,normal,-
5411226011239881906,10.0.2.16,8.8.8.8,53,udp,dns,141,196,1,93,1,289,2,normal,-
-3754958855535400198,10.0.2.16,8.8.8.8,53,udp,dns,67,282,1,84,1,366,2,normal,-
267220236892609542,10.0.2.16,8.8.8.8,53,udp,dns,53,312,1,81,1,393,2,normal,-
1309319229455615383,10.0.2.16,8.8.8.8,53,udp,dns,47,144,1,80,1,224,2,normal,-
3387249178820047566,10.0.2.16,8.8.8.8,53,udp,dns,49,111,1,95,1,206,2,normal,-
5319866669382700099,10.0.2.16,151.101.193.16,443,tcp,-,95,60,1,128,2,188,3,normal,-
-4078035165474069586,10.0.2.16,8.8.8.8,53,udp,dns,50,127,1,99,1,226,2,normal,-
-7260952652918224109,10.0.2.16,8.8.8.8,53,udp,dns,95,196,1,93,1,289,2,normal,-
8522102273563313535,10.0.2.16,8.8.8.8,53,udp,dns,53,102,1,86,1,188,2,normal,-
-4130778341384866073,10.0.2.16,8.8.8.8,53,udp,dns,90,134,1,78,1,212,2,normal,-
-5979229624492081443,10.0.2.16,8.8.8.8,53,udp,dns,36,102,1,86,1,188,2,normal,-
356964079038265194,10.0.2.16,8.8.8.8,53,udp,dns,48,209,1,102,1,311,2,normal,-
-6023788051689960402,10.0.2.16,8.8.8.8,53,udp,dns,58,287,1,87,1,374,2,normal,-
-1979911045615549799,10.0.2.16,8.8.8.8,53,udp,dns,62,135,1,84,1,219,2,normal,-
4374954887587773079,10.0.2.16,8.8.8.8,53,udp,dns,43,279,1,87,1,366,2,normal,-
-2190013560252155882,10.0.2.16,8.8.8.8,53,udp,dns,53,143,1,86,1,229,2,normal,-
-9001228933578942173,10.0.2.16,104.17.50.95,443,udp,-,15788,9969,20,5095,17,15064,37,normal,-
-6047607155893376041,10.0.2.16,8.8.8.8,53,udp,dns,45,123,1,95,1,218,2,normal,-
6125532315907016988,10.0.2.16,142.251.36.98,443,tcp,-,84,60,1,128,2,188,3,normal,-
1479361988463237448,10.0.2.16,151.99.221.211,443,udp,-,226,5243,8,1826,5,7069,13,normal,-
5106869180905553213,10.0.2.16,8.8.8.8,53,udp,dns,58,157,1,92,1,249,2,normal,-
-7933316397917984528,10.0.2.16,8.8.8.8,53,udp,dns,44,146,1,81,1,227,2,normal,-
-7494977331085657723,10.0.2.16,142.251.36.132,443,udp,-,64418,26021,103,9798,78,35819,181,normal,-
5939109760494823541,10.0.2.16,8.8.8.8,53,udp,dns,59,155,1,99,1,254,2,normal,-
3026800025117635634,10.0.2.16,8.8.8.8,53,udp,dns,54,127,1,99,1,226,2,normal,-
1880803983469446002,10.0.2.16,8.8.8.8,53,udp,dns,70,195,1,111,1,306,2,normal,-
8950310419254349005,10.0.2.16,8.8.8.8,53,udp,dns,72,132,1,83,1,215,2,normal,-
-2290630725012149054,10.0.2.16,8.8.8.8,53,udp,dns,106,151,1,86,1,237,2,normal,-
3027687670880522428,10.0.2.16,8.8.8.8,53,udp,dns,66,132,1,83,1,215,2,normal,-
-6363138832785279446,10.0.2.16,8.8.8.8,53,udp,dns,252,137,1,81,1,218,2,normal,-
8467998017798822539,10.0.2.16,8.8.8.8,53,udp,dns,119,134,1,78,1,212,2,normal,-
-3920271337223704612,10.0.2.16,8.8.8.8,53,udp,dns,45,104,1,88,1,192,2,normal,-
7460169083426060171,10.0.2.16,8.8.8.8,53,udp,dns,59,149,1,92,1,241,2,normal,-
7242207283883197102,10.0.2.16,8.8.8.8,53,udp,dns,32,132,1,83,1,215,2,normal,-
8812043997072070720,10.0.2.16,8.8.8.8,53,udp,dns,75,156,1,95,1,251,2,normal,-
7652422102761555866,10.0.2.16,8.8.8.8,53,udp,dns,84,121,1,93,1,214,2,normal,-
-7306866020874418310,10.0.2.16,8.8.8.8,53,udp,dns,67,200,1,86,1,286,2,normal,-
4975721594708666546,10.0.2.16,8.8.8.8,53,udp,dns,71,152,1,96,1,248,2,normal,-
-1156458121108960082,10.0.2.16,8.8.8.8,53,udp,dns,135,164,1,84,1,248,2,normal,-
-8892027090089278444,10.0.2.16,8.8.8.8,53,udp,dns,62,141,1,85,1,226,2,normal,-
-1311057964204152463,10.0.2.16,142.251.36.142,443,udp,-,183,9639,10,2234,10,11873,20,normal,-
-4544228393045909518,10.0.2.16,184.72.105.205,443,tcp,-,133,60,1,128,2,188,3,normal,-
-3984832762275380734,10.0.2.16,8.8.8.8,53,udp,dns,63,164,1,98,1,262,2,normal,-
8225331574209804908,10.0.2.16,8.8.8.8,53,udp,dns,50,178,1,97,1,275,2,normal,-
-7844412319600045265,10.0.2.16,8.8.8.8,53,udp,dns,54,106,1,90,1,196,2,normal,-
-5519524385883370848,10.0.2.16,8.8.8.8,53,udp,dns,50,138,1,90,1,228,2,normal,-
-4973567947994760947,10.0.2.16,8.8.8.8,53,udp,dns,47,162,1,82,1,244,2,normal,-
5609952230940594914,10.0.2.16,8.8.8.8,53,udp,dns,68,208,1,84,1,292,2,normal,-
-1070610579243765310,10.0.2.16,8.8.8.8,53,udp,dns,37,177,1,92,1,269,2,normal,-
7755080524021240071,10.0.2.16,142.251.37.110,443,udp,-,23128,45128,114,106051,128,151179,242,normal,-
3544538404766657257,10.0.2.16,8.8.8.8,53,udp,dns,42,113,1,85,1,198,2,normal,-
8571592693293665366,10.0.2.16,8.8.8.8,53,udp,dns,68,156,1,83,1,239,2,normal,-
-6286309446643649998,10.0.2.16,8.8.8.8,53,udp,dns,139,94,1,78,1,172,2,normal,-
-7207110223379669741,10.0.2.16,8.8.8.8,53,udp,dns,56,112,1,96,1,208,2,normal,-
-6040572225567981335,10.0.2.16,142.251.36.110,443,udp,-,469,10381,10,2308,11,12689,21,normal,-
7892873406539961220,10.0.2.16,8.8.8.8,53,udp,dns,47,158,1,98,1,256,2,normal,-
8036798606050182317,10.0.2.16,8.8.8.8,53,udp,dns,52,97,1,81,1,178,2,normal,-
-6144647268879211583,10.0.2.16,8.8.8.8,53,udp,dns,66,102,1,86,1,188,2,normal,-
-3438695028194773333,10.0.2.16,8.8.8.8,53,udp,dns,44,189,1,118,1,307,2,normal,-
1797089995849350268,10.0.2.16,157.240.30.35,443,udp,-,23433,938545,957,183719,491,1122264,1448,normal,-
-7648053316237037990,10.0.2.16,8.8.8.8,53,udp,dns,68,139,1,83,1,222,2,normal,-
6620757507835259369,10.0.2.16,8.8.8.8,53,udp,dns,49,172,1,91,1,263,2,normal,-
6186257457971004086,10.0.2.16,8.8.8.8,53,udp,dns,51,178,1,97,1,275,2,normal,-
-3097483560254659333,10.0.2.16,8.8.8.8,53,udp,dns,55,141,1,82,1,223,2,normal,-
-7831908810781797502,10.0.2.16,8.8.8.8,53,udp,dns,57,229,1,90,1,319,2,normal,-
-8927962602046355802,10.0.2.16,8.8.8.8,53,udp,dns,56,214,1,130,1,344,2,normal,-
3371409354560057635,10.0.2.16,8.8.8.8,53,udp,dns,53,148,1,92,1,240,2,normal,-
9090658566990412472,10.0.2.16,8.8.8.8,53,udp,dns,75,325,1,98,1,423,2,normal,-
8138840488244593912,10.0.2.16,8.8.8.8,53,udp,dns,45,279,1,87,1,366,2,normal,-
6740730247474571324,10.0.2.16,8.8.8.8,53,udp,dns,54,191,1,95,1,286,2,normal,-
-6920421256051357212,10.0.2.16,8.8.8.8,53,udp,dns,123,164,1,100,1,264,2,normal,-
-8507650586800651993,10.0.2.16,8.8.8.8,53,udp,dns,73,139,1,85,1,224,2,normal,-
2545059113249460667,10.0.2.16,8.8.8.8,53,udp,dns,68,139,1,90,1,229,2,normal,-
-7085184170155682137,10.0.2.16,8.8.8.8,53,udp,dns,40,141,1,84,1,225,2,normal,-
5978378558666284683,10.0.2.16,8.8.8.8,53,udp,dns,57,145,1,86,1,231,2,normal,-
7236301312561615765,10.0.2.16,8.8.8.8,53,udp,dns,205531,374,2,190,2,564,4,normal,-
-9207530715529225373,10.0.2.16,8.8.8.8,53,udp,dns,39,113,1,81,1,194,2,normal,-
7686410749148385837,10.0.2.16,8.8.8.8,53,udp,dns,55,174,1,90,1,264,2,normal,-
-2255659772291140263,10.0.2.16,13.107.238.45,443,tcp,-,138,60,1,128,2,188,3,normal,-
-5493445256852765424,10.0.2.16,142.251.36.138,443,udp,-,867,51918,58,8152,36,60070,94,normal,-
-509702054055411941,10.0.2.16,8.8.8.8,53,udp,dns,51,201,1,87,1,288,2,normal,-
3671785475705524164,10.0.2.16,8.8.8.8,53,udp,dns,46,166,1,82,1,248,2,normal,-
381667554871472188,10.0.2.16,8.8.8.8,53,udp,dns,53,97,1,81,1,178,2,normal,-
-3100109747072333201,10.0.2.16,142.251.36.141,443,udp,-,13821,598644,481,42210,182,640854,663,normal,-
1137450925847996447,10.0.2.16,8.8.8.8,53,udp,dns,52,170,1,88,1,258,2,normal,-
-935242397172704789,10.0.2.16,8.8.8.8,53,udp,dns,118497,289,2,167,2,456,4,normal,-
2269533664779222558,10.0.2.16,8.8.8.8,53,udp,dns,43,140,1,84,1,224,2,normal,-
2988684640912869641,10.0.2.16,8.8.8.8,53,udp,dns,90,152,1,96,1,248,2,normal,-
2907803600693327280,10.0.2.16,8.8.8.8,53,udp,dns,56,156,1,83,1,239,2,normal,-
-6336185799225640305,10.0.2.16,8.8.8.8,53,udp,dns,55,99,1,83,1,182,2,normal,-
-4197532134596678690,10.0.2.16,8.8.8.8,53,udp,dns,130,133,1,85,1,218,2,normal,-
6474694270114500444,10.0.2.16,8.8.8.8,53,udp,dns,64,114,1,82,1,196,2,normal,-
-5914484334108441715,10.0.2.16,8.8.8.8,53,udp,dns,49,149,1,92,1,241,2,normal,-
7646516131439974529,10.0.2.16,8.8.8.8,53,udp,dns,92,138,1,83,1,221,2,normal,-
-5319421483018837120,10.0.2.16,142.251.36.132,443,udp,-,241,10329,13,2469,9,12798,22,normal,-
9145363532007159011,10.0.2.16,8.8.8.8,53,udp,dns,51,230,1,91,1,321,2,normal,-
-7376571046323438391,10.0.2.16,8.8.8.8,53,udp,dns,53,148,1,92,1,240,2,normal,-
-7333613585664565631,10.0.2.16,8.8.8.8,53,udp,dns,51,132,1,83,1,215,2,normal,-
-5116702725128788190,10.0.2.16,8.8.8.8,53,udp,dns,52,146,1,81,1,227,2,normal,-
4084800388001197239,10.0.2.16,8.8.8.8,53,udp,dns,182,157,1,93,1,250,2,normal,-
5046314265920573421,10.0.2.16,8.8.8.8,53,udp,dns,85,161,1,97,1,258,2,normal,-
2237210472159226472,10.0.2.16,8.8.8.8,53,udp,dns,44,156,1,83,1,239,2,normal,-
8942237190057325796,10.0.2.16,8.8.8.8,53,udp,dns,54,106,1,90,1,196,2,normal,-
-8201545911651139471,10.0.2.16,8.8.8.8,53,udp,dns,50,169,1,87,1,256,2,normal,-
-5917413962908120965,10.0.2.16,8.8.8.8,53,udp,dns,52,212,1,84,1,296,2,normal,-
9017207211867877096,10.0.2.16,8.8.8.8,53,udp,dns,51,182,1,82,1,264,2,normal,-
-2438696326465701601,10.0.2.16,8.8.8.8,53,udp,dns,128,126,1,98,1,224,2,normal,-
-6942958642222069902,10.0.2.16,8.8.8.8,53,udp,dns,57,197,1,133,1,330,2,normal,-
-6290915975369462328,10.0.2.16,8.8.8.8,53,udp,dns,51,143,1,75,1,218,2,normal,-
-6479272694424497143,10.0.2.16,8.8.8.8,53,udp,dns,119,147,1,84,1,231,2,normal,-
8803708941649110883,10.0.2.16,8.8.8.8,53,udp,dns,144,148,1,84,1,232,2,normal,-
-580295893480266384,10.0.2.16,8.8.8.8,53,udp,dns,55,141,1,82,1,223,2,normal,-
-2794420124618080049,10.0.2.16,8.8.8.8,53,udp,dns,44,167,1,83,1,250,2,normal,-
4480440407299515209,10.0.2.16,8.8.8.8,53,udp,dns,46,126,1,98,1,224,2,normal,-
8345042487623180235,10.0.2.16,8.8.8.8,53,udp,dns,66,187,1,100,1,287,2,normal,-
-625623139616810983,10.0.2.16,8.8.8.8,53,udp,dns,113,113,1,81,1,194,2,normal,-
-7096280434872275288,10.0.2.16,13.107.238.45,443,tcp,-,42,60,1,128,2,188,3,normal,-
-3863326122111651173,10.0.2.16,8.8.8.8,53,udp,dns,40,148,1,92,1,240,2,normal,-
-4529879950963575627,10.0.2.16,8.8.8.8,53,udp,dns,221,120,1,88,1,208,2,normal,-
-4534486479689387957,10.0.2.16,8.8.8.8,53,udp,dns,80,96,1,80,1,176,2,normal,-
6167701949202101128,10.0.2.16,8.8.8.8,53,udp,dns,182,152,1,88,1,240,2,normal,-
6099589273254101542,10.0.2.16,8.8.8.8,53,udp,dns,50,178,1,97,1,275,2,normal,-
-1813963636865214865,10.0.2.16,8.8.8.8,53,udp,dns,127,229,1,89,1,318,2,normal,-
5136588208532530591,10.0.2.16,8.8.8.8,53,udp,dns,76,206,1,95,1,301,2,normal,-
83329474784926388,10.0.2.16,8.8.8.8,53,udp,dns,66,127,1,99,1,226,2,normal,-
-8096969641139812349,10.0.2.16,8.8.8.8,53,udp,dns,63,386,1,100,1,486,2,normal,-
-9199409604397031759,10.0.2.16,8.8.8.8,53,udp,dns,55,177,1,84,1,261,2,normal,-
1440228530374331362,10.0.2.16,34.107.204.85,443,udp,-,180,6003,7,1899,6,7902,13,normal,-
2960142287079568389,10.0.2.16,8.8.8.8,53,udp,dns,47,212,1,131,1,343,2,normal,-
-4800727925818950657,10.0.2.16,8.8.8.8,53,udp,dns,45,207,1,114,1,321,2,normal,-
-2332446756868329668,10.0.2.16,23.195.249.173,443,tcp,tls,127129,43116,48,3126,33,46242,81,normal,-
-472170981921325811,10.0.2.16,192.229.221.95,80,tcp,http,35384,3241,12,1994,13,5235,25,normal,-
-7256394006127582184,10.0.2.16,8.8.8.8,53,udp,dns,169436,230,2,186,2,416,4,normal,-
-9084280109424774139,10.0.2.16,8.8.8.8,53,udp,dns,52,170,1,87,1,257,2,normal,-
5035294914677162043,10.0.2.16,8.8.8.8,53,udp,dns,51,97,1,81,1,178,2,normal,-
-181407059979375485,10.0.2.16,8.8.8.8,53,udp,dns,53,363,1,91,1,454,2,normal,-
7338843739454328110,10.0.2.16,8.8.8.8,53,udp,dns,53,173,1,91,1,264,2,normal,-
8507804765087559465,10.0.2.16,142.251.36.131,443,udp,-,335,7337,12,2921,16,10258,28,normal,-
-8107044065856681612,10.0.2.16,8.8.8.8,53,udp,dns,62,208,1,85,1,293,2,normal,-
3413900688436449515,10.0.2.16,8.8.8.8,53,udp,dns,56,218,1,142,1,360,2,normal,-
4811220506830278249,10.0.2.16,8.8.8.8,53,udp,dns,45,178,1,97,1,275,2,normal,-
-3767709558347286486,10.0.2.16,8.8.8.8,53,udp,dns,54,181,1,117,1,298,2,normal,-
8644528871485601889,10.0.2.16,8.8.8.8,53,udp,dns,171,95,1,79,1,174,2,normal,-
-4588654373034602867,10.0.2.16,8.8.8.8,53,udp,dns,39,102,1,86,1,188,2,normal,-
-6098987251627679607,10.0.2.16,8.8.8.8,53,udp,dns,37,120,1,88,1,208,2,normal,-
8103229271881229528,10.0.2.16,8.8.8.8,53,udp,dns,66,184,1,99,1,283,2,normal,-
-1044496141298894990,10.0.2.16,8.8.8.8,53,udp,dns,81,125,1,88,1,213,2,normal,-
-4398767632329612602,10.0.2.16,8.8.8.8,53,udp,dns,44,146,1,81,1,227,2,normal,-
8422776075877814967,10.0.2.16,8.8.8.8,53,udp,dns,48,189,1,116,1,305,2,normal,-
1100317136659714749,10.0.2.16,8.8.8.8,53,udp,dns,58,117,1,87,1,204,2,normal,-
3898729753645825450,10.0.2.16,8.8.8.8,53,udp,dns,51,112,1,80,1,192,2,normal,-
-8611638916640663271,10.0.2.16,157.240.30.63,443,udp,-,3004,190762,172,8146,62,198908,234,normal,-
-5202950837700520139,10.0.2.16,142.251.36.142,443,udp,-,257,9733,11,2529,12,12262,23,normal,-
686706562199195855,10.0.2.16,8.8.8.8,53,udp,dns,55,218,1,142,1,360,2,normal,-
-5734736887802126317,10.0.2.16,142.251.36.100,443,udp,-,5451,21151,30,6865,13,28016,43,normal,-
-1048801146081470128,10.0.2.16,8.8.8.8,53,udp,dns,69,177,1,84,1,261,2,normal,-
-7060303277004939799,10.0.2.16,8.8.8.8,53,udp,dns,64,208,1,85,1,293,2,normal,-
-5498991421137721055,10.0.2.16,65.9.9.138,80,tcp,http,140880,7450,28,4184,29,11634,57,normal,-
-7272557320071865813,10.0.2.16,142.251.36.98,443,udp,-,261,3663,12,2345,7,6008,19,normal,-
3662824600745614161,10.0.2.16,8.8.8.8,53,udp,dns,183902,271,2,164,2,435,4,normal,-
4713319026579198104,10.0.2.16,8.8.8.8,53,udp,dns,67,204,1,122,1,326,2,normal,-
-2286840897160172769,10.0.2.16,8.8.8.8,53,udp,dns,40,153,1,92,1,245,2,normal,-
224165552847043842,10.0.2.16,8.8.8.8,53,udp,dns,203,197,1,104,1,301,2,normal,-
-4678482624088659803,10.0.2.16,8.8.8.8,53,udp,dns,62,144,1,88,1,232,2,normal,-
6256527001802145555,10.0.2.16,8.8.8.8,53,udp,dns,64,140,1,101,1,241,2,normal,-
976323990114240066,10.0.2.16,8.8.8.8,53,udp,dns,77,156,1,83,1,239,2,normal,-
-127802516803334395,10.0.2.16,8.8.8.8,53,udp,dns,80,132,1,83,1,215,2,normal,-
-5310077769742517548,10.0.2.16,8.8.8.8,53,udp,dns,45,207,1,114,1,321,2,normal,-
-7350243832300749416,10.0.2.16,8.8.8.8,53,udp,dns,58,239,1,91,1,330,2,normal,-
-7028836404562778592,10.0.2.16,8.8.8.8,53,udp,dns,41,287,1,86,1,373,2,normal,-
-4162245213827027280,10.0.2.16,8.8.8.8,53,udp,dns,62,117,1,85,1,202,2,normal,-
3575686091805924785,10.0.2.16,8.8.8.8,53,udp,dns,97,111,1,95,1,206,2,normal,-
3866371293462905722,10.0.2.16,8.8.8.8,53,udp,dns,60,118,1,102,1,220,2,normal,-
6754884696287153772,10.0.2.16,8.8.8.8,53,udp,dns,77,108,1,92,1,200,2,normal,-
4715486284454639976,10.0.2.16,8.8.8.8,53,udp,dns,212,207,1,114,1,321,2,normal,-
-8621533631303130306,10.0.2.16,8.8.8.8,53,udp,dns,51,178,1,97,1,275,2,normal,-
-7212372650601234854,10.0.2.16,8.8.8.8,53,udp,dns,52,147,1,90,1,237,2,normal,-
-6172390724815044578,10.0.2.16,8.8.8.8,53,udp,dns,64,170,1,88,1,258,2,normal,-
5646319770330177078,10.0.2.16,8.8.8.8,53,udp,dns,52,149,1,93,1,242,2,normal,-
7257462154536484999,10.0.2.16,8.8.8.8,53,udp,dns,49,178,1,97,1,275,2,normal,-
1442619149992241257,10.0.2.16,8.8.8.8,53,udp,dns,130,154,1,109,1,263,2,normal,-
2357089495259011896,10.0.2.16,8.8.8.8,53,udp,dns,102,132,1,87,1,219,2,normal,-
3837408588862146124,10.0.2.16,8.8.8.8,53,udp,dns,40,179,1,92,1,271,2,normal,-
-7320815000917508938,10.0.2.16,8.8.8.8,53,udp,dns,55,260,1,90,1,350,2,normal,-
3531840985384165231,10.0.2.16,8.8.8.8,53,udp,dns,46,107,1,91,1,198,2,normal,-
474925979423509124,10.0.2.16,8.8.8.8,53,udp,dns,51,369,1,102,1,471,2,normal,-
6420060249986804654,10.0.2.16,8.8.8.8,53,udp,dns,81,146,1,81,1,227,2,normal,-
8582351386524087684,10.0.2.16,8.8.8.8,53,udp,dns,49,118,1,86,1,204,2,normal,-
-2005296698442151767,10.0.2.16,8.8.8.8,53,udp,dns,76,214,1,85,1,299,2,normal,-
4833496066775054311,10.0.2.16,8.8.8.8,53,udp,dns,46,159,1,94,1,253,2,normal,-
1484812466772562354,10.0.2.16,8.8.8.8,53,udp,dns,52,234,1,84,1,318,2,normal,-
3014421791138037287,10.0.2.16,8.8.8.8,53,udp,dns,54,112,1,84,1,196,2,normal,-
3622619351568885307,10.0.2.16,8.8.8.8,53,udp,dns,57,96,1,80,1,176,2,normal,-
1790011811539678069,10.0.2.16,142.251.36.142,443,udp,-,128,8754,7,2027,7,10781,14,normal,-
7192780501733569185,10.0.2.16,8.8.8.8,53,udp,dns,69,153,1,97,1,250,2,normal,-
8681606639320535503,10.0.2.16,8.8.8.8,53,udp,dns,65,156,1,83,1,239,2,normal,-
6489823865929138925,10.0.2.16,8.8.8.8,53,udp,dns,59,156,1,83,1,239,2,normal,-
-6805086292309607772,10.0.2.16,8.8.8.8,53,udp,dns,62,144,1,88,1,232,2,normal,-
-7159029597548033668,10.0.2.16,8.8.8.8,53,udp,dns,69,363,1,91,1,454,2,normal,-
-2255054776211708312,10.0.2.16,8.8.8.8,53,udp,dns,54,114,1,86,1,200,2,normal,-
-7761044772998757782,10.0.2.16,8.8.8.8,53,udp,dns,41,180,1,105,1,285,2,normal,-
6083034960005044638,10.0.2.16,8.8.8.8,53,udp,dns,171,107,1,79,1,186,2,normal,-
-5332353329687293610,10.0.2.16,8.8.8.8,53,udp,dns,52,99,1,83,1,182,2,normal,-
-3269351863862278269,10.0.2.16,8.8.8.8,53,udp,dns,51,192,1,80,1,272,2,normal,-
-2960078505337625651,10.0.2.16,8.8.8.8,53,udp,dns,89,191,1,95,1,286,2,normal,-
9140987582335533124,10.0.2.16,8.8.8.8,53,udp,dns,47,110,1,82,1,192,2,normal,-
-4757792068597606111,10.0.2.16,8.8.8.8,53,udp,dns,51,137,1,90,1,227,2,normal,-
4419300538707833383,10.0.2.16,8.8.8.8,53,udp,dns,50,158,1,93,1,251,2,normal,-
-1629783846726742379,10.0.2.16,8.8.8.8,53,udp,dns,132,232,1,92,1,324,2,normal,-
-8882193618462462361,10.0.2.16,157.240.252.13,443,udp,-,127,5428,9,1977,6,7405,15,normal,-
3739692682884031930,10.0.2.16,8.8.8.8,53,udp,dns,43,161,1,105,1,266,2,normal,-
385182137277853472,10.0.2.16,8.8.8.8,53,udp,dns,58,122,1,90,1,212,2,normal,-
6072698709062238747,10.0.2.16,8.8.8.8,53,udp,dns,45,112,1,96,1,208,2,normal,-
-5742807203141113220,10.0.2.16,8.8.8.8,53,udp,dns,46,207,1,114,1,321,2,normal,-
-7522436431502081326,10.0.2.16,8.8.8.8,53,udp,dns,62,120,1,88,1,208,2,normal,-
-6197191424034944512,10.0.2.16,8.8.8.8,53,udp,dns,41,178,1,85,1,263,2,normal,-
-3295679077884967244,10.0.2.16,8.8.8.8,53,udp,dns,50,132,1,83,1,215,2,normal,-
1977079410589162818,10.0.2.16,157.240.30.35,443,udp,-,9038,6933,20,18739,25,25672,45,normal,-
-7155452545773876038,10.0.2.16,8.8.8.8,53,udp,dns,54,173,1,88,1,261,2,normal,-
4391557082772000388,10.0.2.16,8.8.8.8,53,udp,dns,41,178,1,97,1,275,2,normal,-
4157130973219782644,10.0.2.16,172.64.155.188,80,tcp,http,16064,1372,6,823,7,2195,13,normal,-
-502167064742867929,10.0.2.16,8.8.8.8,53,udp,dns,40,141,1,82,1,223,2,normal,-
-6333808870434261918,10.0.2.16,142.251.37.106,443,udp,-,103,11949,9,2278,10,14227,19,normal,-
447322094455526924,10.0.2.16,8.8.8.8,53,udp,dns,43,153,1,89,1,242,2,normal,-
-7886542830909493292,10.0.2.16,8.8.8.8,53,udp,dns,83,246,1,89,1,335,2,normal,-
3437276670221931026,10.0.2.16,8.8.8.8,53,udp,dns,46,102,1,86,1,188,2,normal,-
-5931362942951211593,10.0.2.16,8.8.8.8,53,udp,dns,53,158,1,101,1,259,2,normal,-
8697299585304347804,10.0.2.16,8.8.8.8,53,udp,dns,48,325,1,94,1,419,2,normal,-
2420204599438741381,10.0.2.16,8.8.8.8,53,udp,dns,79,163,1,98,1,261,2,normal,-
-1518195602949061834,10.0.2.16,142.251.36.66,443,udp,-,182,7234,8,1983,7,9217,15,normal,-
-877448310707854607,10.0.2.16,8.8.8.8,53,udp,dns,55,156,1,83,1,239,2,normal,-
5632489617111307604,10.0.2.16,8.8.8.8,53,udp,dns,58,124,1,89,1,213,2,normal,-
-5156654623600854819,10.0.2.16,8.8.8.8,53,udp,dns,61,114,1,86,1,200,2,normal,-
1292540685345517148,10.0.2.16,142.251.36.141,443,udp,-,633,16015,23,4252,16,20267,39,normal,-
1841713452262623976,10.0.2.16,8.8.8.8,53,udp,dns,78,156,1,83,1,239,2,normal,-
1968359813949235340,10.0.2.16,8.8.8.8,53,udp,dns,50,195,1,91,1,286,2,normal,-
-5013307070389008921,10.0.2.16,8.8.8.8,53,udp,dns,44,170,1,88,1,258,2,normal,-
8297815089638611086,10.0.2.16,8.8.8.8,53,udp,dns,47,106,1,90,1,196,2,normal,-
-7851468686217660537,10.0.2.16,8.8.8.8,53,udp,dns,132,149,1,93,1,242,2,normal,-
-3756383572969818621,10.0.2.16,8.8.8.8,53,udp,dns,40,192,1,108,1,300,2,normal,-
-6831115489236225964,10.0.2.16,8.8.8.8,53,udp,dns,72,148,1,92,1,240,2,normal,-
8894505032396897017,10.0.2.16,8.8.8.8,53,udp,dns,41,141,1,84,1,225,2,normal,-
8990103871598195646,10.0.2.16,8.8.8.8,53,udp,dns,48,279,1,94,1,373,2,normal,-
-9218728333737275867,10.0.2.16,8.8.8.8,53,udp,dns,61,141,1,82,1,223,2,normal,-
2272640491390371503,10.0.2.16,151.101.193.16,443,tcp,-,97,60,1,128,2,188,3,normal,-
-5066751508839728933,10.0.2.16,142.251.36.142,443,udp,-,283,9740,11,2359,10,12099,21,normal,-
8859443383617512122,10.0.2.16,8.8.8.8,53,udp,dns,49,245,1,95,1,340,2,normal,-
-196442169957197277,10.0.2.16,34.107.204.85,443,udp,-,6721,11564,18,4549,19,16113,37,normal,-
-4928205434295292706,10.0.2.16,8.8.8.8,53,udp,dns,50,116,1,84,1,200,2,normal,-
8181310218683457578,10.0.2.16,8.8.8.8,53,udp,dns,52,323,1,88,1,411,2,normal,-
2521035708489500776,10.0.2.16,8.8.8.8,53,udp,dns,101,132,1,100,1,232,2,normal,-
8470927646598501789,10.0.2.16,8.8.8.8,53,udp,dns,74,112,1,84,1,196,2,normal,-
141478077319003462,10.0.2.16,8.8.8.8,53,udp,dns,94,100,1,84,1,184,2,normal,-
-2469821241854493347,10.0.2.16,8.8.8.8,53,udp,dns,66,156,1,83,1,239,2,normal,-
-275694961483067121,10.0.2.16,8.8.8.8,53,udp,dns,54,202,1,95,1,297,2,normal,-
1723839053116549285,10.0.2.16,8.8.8.8,53,udp,dns,75,126,1,98,1,224,2,normal,-
-1792012372514151777,10.0.2.16,8.8.8.8,53,udp,dns,78,351,1,85,1,436,2,normal,-
-3764456802166841830,10.0.2.16,8.8.8.8,53,udp,dns,39,195,1,111,1,306,2,normal,-
-3582366877000332205,10.0.2.16,8.8.8.8,53,udp,dns,98,140,1,84,1,224,2,normal,-
2662080620651565158,10.0.2.16,8.8.8.8,53,udp,dns,60,132,1,83,1,215,2,normal,-
6214633310450469316,10.0.2.16,157.240.252.13,443,udp,-,16302,625578,557,26423,212,652001,769,normal,-
-967276561761911543,10.0.2.16,8.8.8.8,53,udp,dns,117,102,1,86,1,188,2,normal,-
6869090868170397491,10.0.2.16,8.8.8.8,53,udp,dns,92,248,1,91,1,339,2,normal,-
-3565635464999583753,10.0.2.16,8.8.8.8,53,udp,dns,53,324,1,100,1,424,2,normal,-
-7027944816822020071,10.0.2.16,8.8.8.8,53,udp,dns,56,143,1,87,1,230,2,normal,-
7366524726022384759,10.0.2.16,8.8.8.8,53,udp,dns,64,310,1,87,1,397,2,normal,-
8966403594219001161,10.0.2.16,8.8.8.8,53,udp,dns,198,185,1,104,1,289,2,normal,-
2838364280344705983,10.0.2.16,8.8.8.8,53,udp,dns,97,170,1,86,1,256,2,normal,-
4412682247420742515,10.0.2.16,8.8.8.8,53,udp,dns,62,117,1,85,1,202,2,normal,-
3411810823464486654,10.0.2.16,8.8.8.8,53,udp,dns,63,187,1,100,1,287,2,normal,-
4558427543816123022,10.0.2.16,142.251.36.132,443,udp,-,125,2290,4,1629,3,3919,7,normal,-
-6619628981578738289,10.0.2.16,8.8.8.8,53,udp,dns,63,184,1,85,1,269,2,normal,-
-2570085058758207195,10.0.2.16,8.8.8.8,53,udp,dns,52,149,1,88,1,237,2,normal,-
-7278580470887288252,10.0.2.16,151.101.193.46,443,udp,-,6920,1042302,756,20415,203,1062717,959,normal,-
5738788622153123932,10.0.2.16,8.8.8.8,53,udp,dns,46,148,1,92,1,240,2,normal,-
-3256553279115221576,10.0.2.16,8.8.8.8,53,udp,dns,49,363,1,85,1,448,2,normal,-
542471363224463163,10.0.2.16,8.8.8.8,53,udp,dns,54,154,1,83,1,237,2,normal,-
-7854363631089677536,10.0.2.16,142.251.36.129,443,udp,-,16134,767901,599,46267,209,814168,808,normal,-
4268331586952243777,10.0.2.16,8.8.8.8,53,udp,dns,88,213,1,85,1,298,2,normal,-
-2161972600764259152,10.0.2.16,8.8.8.8,53,udp,dns,128,144,1,88,1,232,2,normal,-
-1191350969608795337,10.0.2.16,8.8.8.8,53,udp,dns,48,135,1,84,1,219,2,normal,-
498563787434927263,10.0.2.16,8.8.8.8,53,udp,dns,66,163,1,102,1,265,2,normal,-
3885931168898768757,10.0.2.16,8.8.8.8,53,udp,dns,47,148,1,92,1,240,2,normal,-
-8360019632243759171,10.0.2.16,8.8.8.8,53,udp,dns,128,114,1,98,1,212,2,normal,-
-6606004297129360635,10.0.2.16,8.8.8.8,53,udp,dns,51,127,1,99,1,226,2,normal,-
2570049302171575645,10.0.2.16,157.240.30.35,443,udp,-,190,6027,11,2902,7,8929,18,normal,-
348003204078355191,10.0.2.16,8.8.8.8,53,udp,dns,180,183,1,121,1,304,2,normal,-
7292035754530017004,10.0.2.16,8.8.8.8,53,udp,dns,211,226,1,89,1,315,2,normal,-
4417085398897221106,10.0.2.16,8.8.8.8,53,udp,dns,64,186,1,94,1,280,2,normal,-
-8511933988145698917,10.0.2.16,8.8.8.8,53,udp,dns,68,232,1,150,1,382,2,normal,-
-3112112611370997064,10.0.2.16,8.8.8.8,53,udp,dns,48,146,1,81,1,227,2,normal,-
4343681925709856135,10.0.2.16,8.8.8.8,53,udp,dns,95,152,1,95,1,247,2,normal,-
1419482222782220592,10.0.2.16,8.8.8.8,53,udp,dns,60,178,1,97,1,275,2,normal,-
4956846837433460338,10.0.2.16,8.8.8.8,53,udp,dns,54,216,1,134,1,350,2,normal,-
2354698106343811843,10.0.2.16,8.8.8.8,53,udp,dns,36,146,1,81,1,227,2,normal,-
-2274790900752159123,10.0.2.16,8.8.8.8,53,udp,dns,72,148,1,92,1,240,2,normal,-
992488109967942971,10.0.2.16,8.8.8.8,53,udp,dns,46,148,1,92,1,240,2,normal,-
-5447482824659551230,10.0.2.16,8.8.8.8,53,udp,dns,50,187,1,116,1,303,2,normal,-
3409058611982342748,10.0.2.16,8.8.8.8,53,udp,dns,49,102,1,86,1,188,2,normal,-
2976449406334986768,10.0.2.16,8.8.8.8,53,udp,dns,91,156,1,83,1,239,2,normal,-
-8888046380900416280,10.0.2.16,8.8.8.8,53,udp,dns,70,211,1,89,1,300,2,normal,-
598790758799566436,10.0.2.16,8.8.8.8,53,udp,dns,57,127,1,99,1,226,2,normal,-
4683712777878422282,10.0.2.16,8.8.8.8,53,udp,dns,66,179,1,86,1,265,2,normal,-
-4143688536845176754,10.0.2.16,8.8.8.8,53,udp,dns,44,207,1,114,1,321,2,normal,-
5890285656514963716,10.0.2.16,8.8.8.8,53,udp,dns,48,116,1,84,1,200,2,normal,-
-2586864352694126052,10.0.2.16,8.8.8.8,53,udp,dns,42,107,1,91,1,198,2,normal,-
-6301323171201318968,10.0.2.16,8.8.8.8,53,udp,dns,115,144,1,87,1,231,2,normal,-
7618298073200386251,10.0.2.16,8.8.8.8,53,udp,dns,40,124,1,108,1,232,2,normal,-
-8604477923708668880,10.0.2.16,8.8.8.8,53,udp,dns,47,134,1,89,1,223,2,normal,-
-5413073218586547045,10.0.2.16,69.173.144.139,443,tcp,-,1078,60,1,128,2,188,3,normal,-
-4657498031218378345,10.0.2.16,8.8.8.8,53,udp,dns,53,116,1,88,1,204,2,normal,-
8851370154420488913,10.0.2.16,8.8.8.8,53,udp,dns,120,144,1,88,1,232,2,normal,-
-6867465304062742070,10.0.2.16,8.8.8.8,53,udp,dns,103,131,1,99,1,230,2,normal,-
7602155556784211560,10.0.2.16,8.8.8.8,53,udp,dns,61,207,1,114,1,321,2,normal,-
3929016073419848375,10.0.2.16,8.8.8.8,53,udp,dns,50,141,1,82,1,223,2,normal,-
-6320298093030479969,10.0.2.16,8.8.8.8,53,udp,dns,57,146,1,82,1,228,2,normal,-
-2831456058415862856,10.0.2.16,8.8.8.8,53,udp,dns,35,156,1,91,1,247,2,normal,-
1156397477659357176,10.0.2.16,8.8.8.8,53,udp,dns,59,161,1,100,1,261,2,normal,-
-4198393501861923293,10.0.2.16,8.8.8.8,53,udp,dns,56,113,1,85,1,198,2,normal,-
-1985151869399586698,10.0.2.16,8.8.8.8,53,udp,dns,47,150,1,85,1,235,2,normal,-
1756499037242706205,10.0.2.16,8.8.8.8,53,udp,dns,52,179,1,98,1,277,2,normal,-
-2942974915807993820,10.0.2.16,8.8.8.8,53,udp,dns,43,157,1,84,1,241,2,normal,-
5330913368276923089,10.0.2.16,8.8.8.8,53,udp,dns,54,141,1,82,1,223,2,normal,-
997094638693755301,10.0.2.16,8.8.8.8,53,udp,dns,54,120,1,92,1,212,2,normal,-
-1527986066195201354,10.0.2.16,8.8.8.8,53,udp,dns,56,149,1,84,1,233,2,normal,-
1530464008502819927,10.0.2.16,8.8.8.8,53,udp,dns,72,155,1,99,1,254,2,normal,-
988234929098409965,10.0.2.16,8.8.8.8,53,udp,dns,52,142,1,81,1,223,2,normal,-
5600992524193632479,10.0.2.16,8.8.8.8,53,udp,dns,47,152,1,96,1,248,2,normal,-
7895136428285743902,10.0.2.16,8.8.8.8,53,udp,dns,50,112,1,96,1,208,2,normal,-
5185047983098280154,10.0.2.16,8.8.8.8,53,udp,dns,49,141,1,84,1,225,2,normal,-
-4963481832315846977,10.0.2.16,142.251.37.110,443,udp,-,305,14805,12,2241,10,17046,22,normal,-
-5742568148565652374,10.0.2.16,8.8.8.8,53,udp,dns,43,143,1,86,1,229,2,normal,-
6705742026075279357,10.0.2.27,34.117.65.55,443,tcp,tls,33729,1855,12,2154,11,4009,23,normal,-
571035210067461890,10.0.2.27,140.82.114.21,443,tcp,tls,13675,5365,18,2830,18,8195,36,normal,-
2260746354712130226,10.0.2.27,41.220.157.83,443,tcp,tls,564,6598,20,2373,18,8971,38,normal,-
-6970354074256947263,10.0.2.27,142.251.37.106,443,tcp,tls,123,2198,13,2202,13,4400,26,normal,-
5238764652038781010,10.0.2.27,194.228.230.20,443,tcp,tls,24615,4018,13,1567,13,5585,26,normal,-
-5884608675472350658,10.0.2.27,129.205.239.84,443,tcp,tls,1323,6346,17,2240,17,8586,34,normal,-
-7803770407969496282,10.0.2.27,77.75.79.195,443,tcp,tls,784,6505,13,1584,14,8089,27,normal,-
4915315326012145031,10.0.2.27,77.75.77.195,443,tcp,tls,727,6451,12,1530,13,7981,25,normal,-
-5992262490965935610,10.0.2.27,34.160.144.191,443,tcp,tls,33851,18200,28,2525,21,20725,49,normal,-
8439449712566541280,10.0.2.27,91.198.174.192,443,tcp,tls,234,5336,14,1530,13,6866,27,normal,-
-3473362969508449402,10.0.2.27,91.198.174.194,443,tcp,tls,3259,6626,14,1637,14,8263,28,normal,-
-1565758856377119616,10.0.2.27,157.240.30.3,443,tcp,tls,25262,4663,16,1621,14,6284,30,normal,-
7337043833976595890,10.0.2.27,77.75.78.104,443,tcp,tls,7042,6905,13,1925,14,8830,27,normal,-
3881936096309768930,10.0.2.27,91.198.174.208,443,tcp,tls,279,5168,11,1422,11,6590,22,normal,-
3715425337390260176,10.0.2.27,91.198.174.208,443,tcp,tls,1217,23649,34,3817,27,27466,61,normal,-
-4623052115419128526,10.0.2.27,142.251.36.142,443,tcp,tls,32471,8283,15,1675,15,9958,30,normal,-
-1562978333182833606,10.0.2.27,157.240.30.35,443,tcp,tls,26941,4526,14,1621,14,6147,28,normal,-
-2773363527176968896,10.0.2.27,34.120.208.123,443,tcp,tls,34296,16756,92,25635,83,42391,175,normal,-
-660246645127948317,10.0.2.27,157.240.234.1,443,tcp,tls,357,6599,18,2262,16,8861,34,normal,-
7728920344283767283,10.0.2.27,77.75.77.195,443,tcp,tls,125,1462,4,807,5,2269,9,normal,-
-3924639295255131769,10.0.2.27,77.75.78.157,443,tcp,tls,705,6347,14,1568,14,7915,28,normal,-
4116594500589860426,10.0.2.27,77.75.78.157,443,tcp,tls,7301,79636,77,4201,50,83837,127,normal,-
-2318952855664135329,10.0.2.27,77.75.77.195,443,tcp,tls,895,6451,12,1530,13,7981,25,normal,-
7168038315639784878,10.0.2.27,142.251.36.129,443,tcp,tls,183,9717,14,1568,14,11285,28,normal,-
668199159397931580,10.0.2.27,91.198.174.208,443,tcp,tls,352,5222,12,1476,12,6698,24,normal,-
5982164664478100791,10.0.2.27,77.75.79.195,443,tcp,tls,6381,7215,16,2022,15,9237,31,normal,-
-4982078652722975481,10.0.2.27,77.75.77.195,443,tcp,tls,701,6473,12,1530,13,8003,25,normal,-
-264572966628742638,10.0.2.27,77.75.76.101,443,tcp,tls,5509,42250,43,3586,30,45836,73,normal,-
-2073171701792142470,10.0.2.27,142.251.37.106,443,tcp,tls,662,2150,12,2149,12,4299,24,normal,-
5170599960002004173,10.0.2.27,77.75.78.36,443,tcp,tls,123,3268,6,861,6,4129,12,normal,-
-4355388428657865650,10.0.2.27,91.198.174.208,443,tcp,tls,278,5168,11,1422,11,6590,22,normal,-
-959184053607970768,10.0.2.27,185.199.111.154,443,tcp,tls,615,4978,12,1460,12,6438,24,normal,-
3048372164104437969,10.0.2.27,77.75.76.104,443,tcp,tls,6202,6495,14,1397,14,7892,28,normal,-
-3537196688282407880,10.0.2.27,77.75.76.30,443,tcp,tls,448,6430,14,1568,14,7998,28,normal,-
8128234488227916255,10.0.2.27,185.199.111.154,443,tcp,tls,331,4978,12,1460,12,6438,24,normal,-
-852186489399725923,10.0.2.27,65.9.95.67,443,tcp,tls,35203,10888,22,2839,22,13727,44,normal,-
-6287328464015181352,10.0.2.27,77.75.77.69,443,tcp,tls,6181,6481,16,1729,16,8210,32,normal,-
-7935049088870653374,10.0.2.27,77.75.76.20,443,tcp,tls,5855,6918,17,2075,16,8993,33,normal,-
-1542652659359168830,10.0.2.27,142.251.36.129,443,tcp,tls,170,9719,14,1568,14,11287,28,normal,-
8302758605869283320,10.0.2.27,142.251.37.106,443,tcp,tls,166,2204,13,2148,12,4352,25,normal,-
1726257966259724597,10.0.2.27,157.240.249.8,443,tcp,tls,774,6279,20,2292,18,8571,38,normal,-
-8101559847790162128,10.0.2.27,77.75.76.20,443,tcp,tls,6181,7585,34,25519,34,33104,68,normal,-
8764177848061050879,10.0.2.27,157.240.202.1,443,tcp,tls,380,6444,20,2236,17,8680,37,normal,-
-6186812831181340711,10.0.2.27,185.199.111.154,443,tcp,tls,185,4834,10,1406,11,6240,21,normal,-
8994957056862606743,10.0.2.27,157.240.221.16,443,tcp,tls,24696,4727,17,1729,16,6456,33,normal,-
-8655641810385046993,10.0.2.27,157.240.130.17,443,tcp,tls,883,6064,19,2309,18,8373,37,normal,-
-1270870245642771294,10.0.2.27,77.75.78.157,443,tcp,tls,812,6347,14,1568,14,7915,28,normal,-
1571905386307099314,10.0.2.27,95.100.146.66,80,tcp,http,6558,1122,4,713,5,1835,9,normal,-
5898231942839440829,10.0.2.27,77.75.76.104,443,tcp,tls,731,14365,28,4154,26,18519,54,normal,-
-3036847695819081226,10.0.2.27,34.117.237.239,443,tcp,tls,35003,6625,19,2224,20,8849,39,normal,-
1344331128812140070,10.0.2.27,91.198.174.208,443,tcp,tls,278,5169,11,1422,11,6591,22,normal,-
7386942626544953749,10.0.2.27,77.75.77.195,443,tcp,tls,542,6473,12,1530,13,8003,25,normal,-
-2914000535177406532,10.0.2.27,179.184.204.17,443,tcp,tls,1449,6096,19,2290,18,8386,37,normal,-
-5106297402084422567,10.0.2.27,140.82.121.6,443,tcp,tls,13984,6764,44,39398,42,46162,86,normal,-
7108539063579465261,10.0.2.27,52.41.179.165,443,tcp,tls,5247,4895,14,1816,13,6711,27,normal,-
1534945288484666426,10.0.2.27,142.251.36.132,443,tcp,tls,33107,5687,13,1621,14,7308,27,normal,-
-2413394325535775023,10.0.2.27,142.251.37.118,443,tcp,tls,32354,6206,14,1621,14,7827,28,normal,-
-3947506868983367286,10.0.2.27,77.75.78.104,443,tcp,tls,583,8979,15,2976,16,11955,31,normal,-
-4306299133538321265,10.0.2.27,91.198.174.192,443,tcp,tls,142,3216,6,861,6,4077,12,normal,-
6994361189834466199,10.0.2.27,142.251.36.130,443,tcp,tls,31413,6045,15,1729,16,7774,31,normal,-
-1571800116291901974,10.0.2.27,77.75.77.222,443,tcp,tls,8252,119992,113,8209,77,128201,190,normal,-
-4619829614910378616,10.0.2.27,91.198.174.192,443,tcp,tls,3047,202561,204,14682,141,217243,345,normal,-
-604797744733303890,10.0.2.27,34.160.144.191,443,tcp,tls,34874,11912,21,2157,22,14069,43,normal,-
7650132481809245413,10.0.2.27,77.75.79.129,443,tcp,tls,5874,6848,18,2149,18,8997,36,normal,-
-7252207878111063230,10.0.2.27,34.120.208.123,443,tcp,tls,357,4644,14,1251,13,5895,27,normal,-
5047122611775856785,10.0.2.27,35.201.103.21,443,tcp,tls,34432,7340,18,2121,18,9461,36,normal,-
-1269358846652258192,10.0.2.27,142.251.37.106,443,tcp,tls,186,2258,14,2201,13,4459,27,normal,-
4146174470792994057,10.0.2.27,77.75.78.157,443,tcp,tls,977,6401,15,1622,15,8023,30,normal,-
-1125694812527479522,10.0.2.27,185.199.111.154,443,tcp,tls,186,4919,12,1460,12,6379,24,normal,-
2726133625282999206,10.0.2.27,77.75.77.195,443,tcp,tls,693,6451,12,1530,13,7981,25,normal,-
-3694600369311889926,10.0.2.27,77.75.78.209,443,tcp,tls,7227,6238,16,1729,16,7967,32,normal,-
-669745060708389901,10.0.2.27,77.75.77.195,443,tcp,tls,1196,6451,12,1476,12,7927,24,normal,-
-1412331475450894346,10.0.2.27,65.9.95.67,443,tcp,tls,187,5044,11,1140,11,6184,22,normal,-
-7175342548131229104,10.0.2.27,185.199.111.154,443,tcp,tls,163,4834,10,1406,11,6240,21,normal,-
3624996682467180560,10.0.2.27,77.75.76.30,443,tcp,tls,407,6430,14,1568,14,7998,28,normal,-
4728089150308502027,10.0.2.27,77.75.78.36,443,tcp,tls,5420,6572,16,1729,16,8301,32,normal,-
3562679209654844672,10.0.2.27,77.75.77.195,443,tcp,tls,755,6451,12,1530,13,7981,25,normal,-
-7862628385948980009,10.0.2.27,41.226.49.147,443,tcp,tls,510,6344,19,2295,18,8639,37,normal,-
1061981976836405476,10.0.2.27,185.199.111.154,443,tcp,tls,14406,6101,20,2781,20,8882,40,normal,-
8818077248695889507,10.0.2.27,140.82.121.4,443,tcp,tls,14773,49117,48,3388,31,52505,79,normal,-
3922916820476699895,10.0.2.27,142.251.36.138,443,tcp,tls,405,11999,20,2453,18,14452,38,normal,-
6644194063467058215,10.0.2.27,142.251.37.106,443,tcp,tls,576,2204,13,2201,13,4405,26,normal,-
-1616978394791456918,10.0.2.27,90.244.158.17,443,tcp,tls,561,6115,17,2239,17,8354,34,normal,-
8157145678888048470,10.0.2.27,142.251.36.129,443,tcp,tls,30914,17896,28,2787,24,20683,52,normal,-
-7428668455619686679,10.0.2.27,34.117.65.55,443,tcp,tls,34649,5946,14,1675,15,7621,29,normal,-
-5462119893014541586,10.0.2.27,77.75.77.195,443,tcp,tls,621,6641,15,1638,15,8279,30,normal,-
-4993692599302524950,10.0.2.27,142.251.37.99,443,tcp,tls,32107,6309,23,2941,24,9250,47,normal,-
-7714521840954635221,10.0.2.27,157.240.30.27,443,tcp,tls,25766,4479,13,1513,12,5992,25,normal,-
-7985735058297356491,10.0.2.27,77.75.79.195,443,tcp,tls,191,6565,14,1584,14,8149,28,normal,-
895471217916896722,10.0.2.27,185.199.111.154,443,tcp,tls,14682,5152,15,1621,14,6773,29,normal,-
-3703707447201916634,10.0.2.27,77.75.76.30,443,tcp,tls,1010,8757,33,13557,31,22314,64,normal,-
-4295600600217098511,10.0.2.27,95.100.146.66,80,tcp,-,6640,120,2,256,4,376,6,normal,-
6308345702282674666,10.0.2.27,77.75.76.30,443,tcp,tls,5901,7452,21,2525,21,9977,42,normal,-
-5978695106647762423,10.0.2.27,77.75.79.195,443,tcp,tls,234,6527,13,1530,13,8057,26,normal,-
-6042888649369047614,10.0.2.27,77.75.77.195,443,tcp,tls,117,3268,6,861,6,4129,12,normal,-
-2587653807598636001,10.0.2.27,179.184.204.17,443,tcp,tls,899,4059,11,1352,10,5411,21,normal,-
238875334590147485,10.0.2.27,77.75.77.195,443,tcp,tls,875,6451,12,1530,13,7981,25,normal,-
-6822967604153623190,10.0.2.27,157.240.30.3,443,tcp,tls,12511,2079,22,3293,18,5372,40,normal,-
-5838847459851474901,10.0.2.27,77.75.77.195,443,tcp,tls,904,6587,14,1584,14,8171,28,normal,-
-8491929372794640675,10.0.2.27,185.199.111.154,443,tcp,tls,159,4834,10,1406,11,6240,21,normal,-
-2879826482175681643,10.0.2.27,34.98.75.36,443,tcp,tls,34282,6567,19,2139,18,8706,37,normal,-
-6551377126027369902,10.0.2.27,77.75.77.195,443,tcp,tls,537,6451,12,1530,13,7981,25,normal,-
1409988584016152044,10.0.2.27,142.251.37.102,443,tcp,tls,29288,5987,14,1675,15,7662,29,normal,-
8405052313697975773,10.0.2.27,77.75.77.195,443,tcp,tls,7657,507880,430,18356,240,526236,670,normal,-
-8724087700381857239,10.0.2.27,142.251.37.97,443,tcp,tls,648,792675,555,15376,257,808051,812,normal,-
7947597650513625325,10.0.2.27,185.199.111.154,443,tcp,tls,183,4799,10,1406,11,6205,21,normal,-
1510841887731648824,10.0.2.27,91.198.174.208,443,tcp,tls,278,5169,11,1368,10,6537,21,normal,-
-784116816397052476,10.0.2.27,142.251.37.106,443,tcp,tls,29547,6137,14,1675,15,7812,29,normal,-
-4245243349447762905,10.0.2.27,142.251.37.97,443,tcp,tls,323,9719,14,1622,15,11341,29,normal,-
-4858838959391312352,10.0.2.27,8.8.8.8,53,udp,dns,76,141,1,90,1,231,2,normal,-
3721058945479981581,10.0.2.27,8.8.8.8,53,udp,dns,59,115,1,99,1,214,2,normal,-
4367106318846209192,10.0.2.27,77.75.76.30,443,tcp,-,42,60,1,128,2,188,3,normal,-
3288631036024623101,10.0.2.27,8.8.8.8,53,udp,dns,58,141,1,85,1,226,2,normal,-
3941723924750536069,10.0.2.27,95.100.146.66,80,tcp,http,6967,4188,11,2360,12,6548,23,normal,-
-5322170391119658219,10.0.2.27,8.8.8.8,53,udp,dns,45,144,1,88,1,232,2,normal,-
4421765165042102174,10.0.2.27,95.100.146.66,80,tcp,-,5278,180,3,236,4,416,7,normal,-
-7186816014556090412,10.0.2.27,8.8.8.8,53,udp,dns,42,116,1,84,1,200,2,normal,-
1200652621875120050,10.0.2.27,8.8.8.8,53,udp,dns,52,207,1,114,1,321,2,normal,-
1158450316029517502,10.0.2.27,8.8.8.8,53,udp,dns,51,233,1,101,1,334,2,normal,-
2813649323325096395,10.0.2.27,8.8.8.8,53,udp,dns,38,192,1,108,1,300,2,normal,-
153974302391154583,10.0.2.27,8.8.8.8,53,udp,dns,52,131,1,82,1,213,2,normal,-
8351142767298155546,10.0.2.27,142.251.36.132,443,udp,-,29643,21718,77,8277,66,29995,143,normal,-
5757683223826979461,10.0.2.27,8.8.8.8,53,udp,dns,40,130,1,82,1,212,2,normal,-
-2685483327599401361,10.0.2.27,8.8.8.8,53,udp,dns,57,133,1,88,1,221,2,normal,-
-7467245495304204586,10.0.2.27,8.8.8.8,53,udp,dns,51,117,1,101,1,218,2,normal,-
1726930357503645762,10.0.2.27,8.8.8.8,53,udp,dns,62,165,1,81,1,246,2,normal,-
1630927860887642599,10.0.2.27,8.8.8.8,53,udp,dns,51,207,1,114,1,321,2,normal,-
-6022050519848231599,10.0.2.27,8.8.8.8,53,udp,dns,89,111,1,83,1,194,2,normal,-
3430356019259934586,10.0.2.27,8.8.8.8,53,udp,dns,41,115,1,99,1,214,2,normal,-
3813080732907122580,10.0.2.27,8.8.8.8,53,udp,dns,62,136,1,89,1,225,2,normal,-
2764483199188457538,10.0.2.27,8.8.8.8,53,udp,dns,41,116,1,84,1,200,2,normal,-
-2394655126540704950,10.0.2.27,8.8.8.8,53,udp,dns,44,106,1,78,1,184,2,normal,-
-4369752771334531684,10.0.2.27,8.8.8.8,53,udp,dns,51,156,1,83,1,239,2,normal,-
-6932486675623645179,10.0.2.27,8.8.8.8,53,udp,dns,44,220,1,95,1,315,2,normal,-
7462999729800167588,10.0.2.27,8.8.8.8,53,udp,dns,147,184,1,86,1,270,2,normal,-
20708066277792596,10.0.2.27,77.75.77.195,443,tcp,-,51,60,1,128,2,188,3,normal,-
1986261465644667048,10.0.2.27,8.8.8.8,53,udp,dns,87,99,1,83,1,182,2,normal,-
-2906938964626995020,10.0.2.27,95.100.146.66,80,tcp,http,6955,4189,11,2360,12,6549,23,normal,-
3262078165765495810,10.0.2.27,129.205.239.84,443,udp,-,810,9405,15,2247,9,11652,24,normal,-
8183619185865420645,10.0.2.27,90.244.158.17,443,udp,-,166,5244,8,1953,7,7197,15,normal,-
2149993734584389705,10.0.2.27,8.8.8.8,53,udp,dns,63,109,1,93,1,202,2,normal,-
1523804015553812547,10.0.2.27,8.8.8.8,53,udp,dns,42,140,1,84,1,224,2,normal,-
-4878193366057683567,10.0.2.27,8.8.8.8,53,udp,dns,37,116,1,84,1,200,2,normal,-
7655837702742365317,10.0.2.27,8.8.8.8,53,udp,dns,53,127,1,99,1,226,2,normal,-
5764301515114070329,10.0.2.27,8.8.8.8,53,udp,dns,52,156,1,83,1,239,2,normal,-
8844711329684429101,10.0.2.27,8.8.8.8,53,udp,dns,48,152,1,96,1,248,2,normal,-
4135498575210073079,10.0.2.27,8.8.8.8,53,udp,dns,89,132,1,87,1,219,2,normal,-
6395922939265570265,10.0.2.27,8.8.8.8,53,udp,dns,58,100,1,84,1,184,2,normal,-
-2561165885460213704,10.0.2.27,8.8.8.8,53,udp,dns,49,170,1,88,1,258,2,normal,-
-3597183658407660306,10.0.2.27,8.8.8.8,53,udp,dns,48,148,1,92,1,240,2,normal,-
-1249399533813380686,10.0.2.27,8.8.8.8,53,udp,dns,89,144,1,87,1,231,2,normal,-
-5772864781313130325,10.0.2.27,8.8.8.8,53,udp,dns,34,156,1,83,1,239,2,normal,-
259481771692492559,10.0.2.27,157.240.30.27,443,udp,-,1313,18708,31,4815,17,23523,48,normal,-
-6053618557654957473,10.0.2.27,8.8.8.8,53,udp,dns,56,194,1,82,1,276,2,normal,-
2613599488451120060,10.0.2.27,8.8.8.8,53,udp,dns,82,144,1,87,1,231,2,normal,-
1577408558729853637,10.0.2.27,8.8.8.8,53,udp,dns,62,120,1,92,1,212,2,normal,-
4376916550469260063,10.0.2.27,8.8.8.8,53,udp,dns,44,129,1,101,1,230,2,normal,-
4851423996968128210,10.0.2.27,8.8.8.8,53,udp,dns,62,132,1,83,1,215,2,normal,-
2143912514968830466,10.0.2.27,8.8.8.8,53,udp,dns,45,148,1,92,1,240,2,normal,-
5622639337349631914,10.0.2.27,8.8.8.8,53,udp,dns,93,218,1,95,1,313,2,normal,-
-4085018285803842372,10.0.2.27,8.8.8.8,53,udp,dns,58,132,1,87,1,219,2,normal,-
435194205515462611,10.0.2.27,8.8.8.8,53,udp,dns,55,153,1,96,1,249,2,normal,-
8918114802871794072,10.0.2.27,8.8.8.8,53,udp,dns,37,111,1,83,1,194,2,normal,-
-24156517024021092,10.0.2.27,8.8.8.8,53,udp,dns,50,140,1,91,1,231,2,normal,-
-1330632071431488725,10.0.2.27,8.8.8.8,53,udp,dns,57,179,1,98,1,277,2,normal,-
-8768315623088391632,10.0.2.27,8.8.8.8,53,udp,dns,59,274,1,84,1,358,2,normal,-
8489843851709885532,10.0.2.27,8.8.8.8,53,udp,dns,47,208,1,85,1,293,2,normal,-
613030949812439230,10.0.2.27,8.8.8.8,53,udp,dns,35,134,1,89,1,223,2,normal,-
3286802997278596868,10.0.2.27,8.8.8.8,53,udp,dns,53,207,1,114,1,321,2,normal,-
1333917274848822282,10.0.2.27,8.8.8.8,53,udp,dns,55,132,1,83,1,215,2,normal,-
93836708946274753,10.0.2.27,8.8.8.8,53,udp,dns,35,114,1,98,1,212,2,normal,-
-4370938434193489261,10.0.2.27,8.8.8.8,53,udp,dns,44,127,1,99,1,226,2,normal,-
-6372101466784068342,10.0.2.27,8.8.8.8,53,udp,dns,56,115,1,99,1,214,2,normal,-
-1938765994281612831,10.0.2.27,8.8.8.8,53,udp,dns,35,99,1,83,1,182,2,normal,-
-1314680727655604475,10.0.2.27,8.8.8.8,53,udp,dns,50,207,1,114,1,321,2,normal,-
8767992294845746404,10.0.2.27,8.8.8.8,53,udp,dns,46,180,1,99,1,279,2,normal,-
6991115277966922204,10.0.2.27,8.8.8.8,53,udp,dns,49,260,1,106,1,366,2,normal,-
154537652560328403,10.0.2.27,8.8.8.8,53,udp,dns,41,207,1,114,1,321,2,normal,-
690122162180005306,10.0.2.27,8.8.8.8,53,udp,dns,38,124,1,108,1,232,2,normal,-
2892809720534307631,10.0.2.27,8.8.8.8,53,udp,dns,41,268,1,100,1,368,2,normal,-
-4084054002661351417,10.0.2.27,157.240.202.1,443,udp,-,162,5659,9,1824,5,7483,14,normal,-
653984149992679947,10.0.2.27,142.251.37.99,80,tcp,http,32865,5194,17,3552,18,8746,35,normal,-
7612046433693184933,10.0.2.27,142.251.36.130,443,udp,-,539,8642,17,2930,14,11572,31,normal,-
465337525887770062,10.0.2.27,8.8.8.8,53,udp,dns,53,135,1,84,1,219,2,normal,-
-2423293535547751574,10.0.2.27,8.8.8.8,53,udp,dns,54,193,1,88,1,281,2,normal,-
1772282620178791278,10.0.2.27,142.251.36.132,443,udp,-,169,9635,10,2235,10,11870,20,normal,-
5227828436424296119,10.0.2.27,8.8.8.8,53,udp,dns,38,132,1,83,1,215,2,normal,-
3468005276682219699,10.0.2.27,8.8.8.8,53,udp,dns,77,170,1,88,1,258,2,normal,-
-748388624187235788,10.0.2.27,8.8.8.8,53,udp,dns,43,158,1,95,1,253,2,normal,-
-417931660906011902,10.0.2.27,95.100.146.66,80,tcp,-,5272,180,3,236,4,416,7,normal,-
510989067618027635,10.0.2.27,8.8.8.8,53,udp,dns,47,118,1,102,1,220,2,normal,-
-882266203456246934,10.0.2.27,31.30.189.145,443,udp,-,1497,210730,183,9805,45,220535,228,normal,-
-3003414868927779222,10.0.2.27,8.8.8.8,53,udp,dns,55,207,1,114,1,321,2,normal,-
8837529688228164413,10.0.2.27,8.8.8.8,53,udp,dns,58,127,1,99,1,226,2,normal,-
2941008004977217290,10.0.2.27,8.8.8.8,53,udp,dns,41,148,1,92,1,240,2,normal,-
-614849649075149068,10.0.2.27,8.8.8.8,53,udp,dns,57,126,1,98,1,224,2,normal,-
564656416264941795,10.0.2.27,8.8.8.8,53,udp,dns,48,128,1,96,1,224,2,normal,-
-3455726949412713711,10.0.2.27,8.8.8.8,53,udp,dns,45,114,1,86,1,200,2,normal,-
-8391883981827371019,10.0.2.27,8.8.8.8,53,udp,dns,49,117,1,85,1,202,2,normal,-
1264797203006504235,10.0.2.27,8.8.8.8,53,udp,dns,46,189,1,91,1,280,2,normal,-
2430063242412663798,10.0.2.27,8.8.8.8,53,udp,dns,49,148,1,92,1,240,2,normal,-
9208640311774305723,10.0.2.27,8.8.8.8,53,udp,dns,63,207,1,114,1,321,2,normal,-
-4317072064791511543,10.0.2.27,8.8.8.8,53,udp,dns,47,264,1,107,1,371,2,normal,-
-4384563118642866915,10.0.2.27,8.8.8.8,53,udp,dns,56,117,1,101,1,218,2,normal,-
-8168634414272500949,10.0.2.27,8.8.8.8,53,udp,dns,56,129,1,101,1,230,2,normal,-
7358537239025651896,10.0.2.27,8.8.8.8,53,udp,dns,40,116,1,84,1,200,2,normal,-
400216214614670089,10.0.2.27,77.75.77.195,443,tcp,-,40,60,1,128,2,188,3,normal,-
5886422884996463386,10.0.2.27,142.251.37.118,443,udp,-,2018,555985,418,12365,95,568350,513,normal,-
3360205302253014271,10.0.2.27,8.8.8.8,53,udp,dns,62,156,1,83,1,239,2,normal,-
4799806983087756773,10.0.2.27,142.251.37.99,80,tcp,http,34415,1176,8,933,9,2109,17,normal,-
7963805170656820666,10.0.2.27,8.8.8.8,53,udp,dns,51,156,1,83,1,239,2,normal,-
-1117608403516477795,10.0.2.27,8.8.8.8,53,udp,dns,43,217,1,124,1,341,2,normal,-
3546275936608386060,10.0.2.27,8.8.8.8,53,udp,dns,38,156,1,83,1,239,2,normal,-
3830246791804530757,10.0.2.27,8.8.8.8,53,udp,dns,76,156,1,92,1,248,2,normal,-
-6054946051702682956,10.0.2.27,8.8.8.8,53,udp,dns,63,147,1,84,1,231,2,normal,-
-8584578955367853274,10.0.2.27,8.8.8.8,53,udp,dns,53,132,1,83,1,215,2,normal,-
-712390306759285360,10.0.2.27,8.8.8.8,53,udp,dns,87,107,1,91,1,198,2,normal,-
-2567734203291976086,10.0.2.27,8.8.8.8,53,udp,dns,59,142,1,91,1,233,2,normal,-
-4373005527514976340,10.0.2.27,8.8.8.8,53,udp,dns,58,152,1,88,1,240,2,normal,-
-4873655391961266761,10.0.2.27,34.107.221.82,80,tcp,http,34727,690,8,809,9,1499,17,normal,-
982130979010249570,10.0.2.27,8.8.8.8,53,udp,dns,49,184,1,85,1,269,2,normal,-
-4500962826899194697,10.0.2.27,8.8.8.8,53,udp,dns,40,165,1,81,1,246,2,normal,-
-7777491430912926078,10.0.2.27,95.100.146.66,80,tcp,http,34733,12328,29,6608,28,18936,57,normal,-
7882184531163516709,10.0.2.27,8.8.8.8,53,udp,dns,62,159,1,102,1,261,2,normal,-
-6544595589928637444,10.0.2.27,8.8.8.8,53,udp,dns,41,132,1,83,1,215,2,normal,-
3181246532677803989,10.0.2.27,8.8.8.8,53,udp,dns,41,117,1,101,1,218,2,normal,-
-6844069477878611238,10.0.2.27,8.8.8.8,53,udp,dns,57,145,1,88,1,233,2,normal,-
-1452553077568066605,10.0.2.27,8.8.8.8,53,udp,dns,49,119,1,91,1,210,2,normal,-
3845439193090042308,10.0.2.27,8.8.8.8,53,udp,dns,49,116,1,84,1,200,2,normal,-
3165667366430803118,10.0.2.27,8.8.8.8,53,udp,dns,43,115,1,99,1,214,2,normal,-
-6068513455388405289,10.0.2.27,8.8.8.8,53,udp,dns,80,126,1,98,1,224,2,normal,-
-1816403033940048391,10.0.2.27,8.8.8.8,53,udp,dns,57,129,1,90,1,219,2,normal,-
-8224368856240902188,10.0.2.27,8.8.8.8,53,udp,dns,61,158,1,101,1,259,2,normal,-
5971181494045745674,10.0.2.27,8.8.8.8,53,udp,dns,49,115,1,99,1,214,2,normal,-
-3490157550004530242,10.0.2.27,8.8.8.8,53,udp,dns,53,120,1,88,1,208,2,normal,-
-6697863240756136839,10.0.2.27,8.8.8.8,53,udp,dns,61,159,1,94,1,253,2,normal,-
-631190018033439749,10.0.2.27,8.8.8.8,53,udp,dns,53,115,1,99,1,214,2,normal,-
-7426262951667535689,10.0.2.27,8.8.8.8,53,udp,dns,45,207,1,114,1,321,2,normal,-
-2492019535120253466,10.0.2.27,8.8.8.8,53,udp,dns,84,132,1,83,1,215,2,normal,-
5480929277650023094,10.0.2.27,8.8.8.8,53,udp,dns,51,141,1,96,1,237,2,normal,-
1551343170933101290,10.0.2.27,8.8.8.8,53,udp,dns,62,108,1,92,1,200,2,normal,-
-7435722256113250868,10.0.2.27,157.240.30.35,443,udp,-,14632,421456,420,55939,150,477395,570,normal,-
4223104379145190903,10.0.2.27,8.8.8.8,53,udp,dns,59,127,1,99,1,226,2,normal,-
7906771286092650420,10.0.2.27,8.8.8.8,53,udp,dns,50,101,1,85,1,186,2,normal,-
850074879115322332,10.0.2.27,142.251.37.99,80,tcp,http,31296,2747,11,1948,12,4695,23,normal,-
-5003864580742238898,10.0.2.27,8.8.8.8,53,udp,dns,54,132,1,83,1,215,2,normal,-
-4934252103619797780,10.0.2.27,8.8.8.8,53,udp,dns,47,178,1,88,1,266,2,normal,-
-2414635352744026331,10.0.2.27,8.8.8.8,53,udp,dns,173,112,1,84,1,196,2,normal,-
-3713234089223202494,10.0.2.27,41.226.49.147,443,udp,-,202,5247,8,1953,7,7200,15,normal,-
5903845042962033424,10.0.2.27,77.75.77.195,443,tcp,-,42,60,1,128,2,188,3,normal,-
-7169081427261182977,10.0.2.27,142.251.36.142,443,udp,-,3913,1163455,922,75606,226,1239061,1148,normal,-
4153612129773989477,10.0.2.27,8.8.8.8,53,udp,dns,56,116,1,84,1,200,2,normal,-
-3009144591144772783,10.0.2.27,8.8.8.8,53,udp,dns,58,155,1,82,1,237,2,normal,-
-4634551775466609903,10.0.2.27,8.8.8.8,53,udp,dns,53,146,1,82,1,228,2,normal,-
4278514525519879168,10.0.2.27,8.8.8.8,53,udp,dns,141,180,1,95,1,275,2,normal,-
-8325199965291661583,10.0.2.27,8.8.8.8,53,udp,dns,49,248,1,100,1,348,2,normal,-
-7584351075511613637,10.0.2.27,8.8.8.8,53,udp,dns,51,158,1,101,1,259,2,normal,-
-6350936002303535463,10.0.2.27,157.240.221.16,443,udp,-,221,7490,12,2554,8,10044,20,normal,-
4299112017325574582,10.0.2.27,8.8.8.8,53,udp,dns,48,130,1,91,1,221,2,normal,-
4775847479023083094,10.0.2.27,41.220.157.83,443,udp,-,220,5240,8,1826,5,7066,13,normal,-
-6012454717826291076,10.0.2.27,8.8.8.8,53,udp,dns,52,101,1,85,1,186,2,normal,-
-4943825133991262521,10.0.2.27,8.8.8.8,53,udp,dns,40,156,1,83,1,239,2,normal,-
919920795122888748,10.0.2.27,157.240.30.27,443,udp,-,2469,221502,231,14549,84,236051,315,normal,-
6964762953659538606,10.0.2.27,8.8.8.8,53,udp,dns,54,156,1,83,1,239,2,normal,-
428314088002435115,10.0.2.27,8.8.8.8,53,udp,dns,40,307,1,101,1,408,2,normal,-
3479379143994857969,10.0.2.27,8.8.8.8,53,udp,dns,49,152,1,96,1,248,2,normal,-
-4059102868614035610,10.0.2.27,8.8.8.8,53,udp,dns,49,140,1,84,1,224,2,normal,-
-4403887446350435513,10.0.2.27,8.8.8.8,53,udp,dns,41,207,1,114,1,321,2,normal,-
8369738298258260815,10.0.2.27,224.0.0.251,5353,udp,-,0,0,0,183,1,183,1,normal,-
8106501872460323505,10.0.2.27,8.8.8.8,53,udp,dns,39,134,1,89,1,223,2,normal,-
8685412432696698953,10.0.2.27,8.8.8.8,53,udp,dns,44,94,1,78,1,172,2,normal,-
-7886972556943206361,10.0.2.27,8.8.8.8,53,udp,dns,73,162,1,98,1,260,2,normal,-
-2557327007460119446,10.0.2.27,8.8.8.8,53,udp,dns,38,117,1,101,1,218,2,normal,-
5557922416983792458,10.0.2.27,8.8.8.8,53,udp,dns,48,114,1,98,1,212,2,normal,-
5761048758933625673,10.0.2.27,8.8.8.8,53,udp,dns,41,190,1,107,1,297,2,normal,-
13492740398264021,10.0.2.27,8.8.8.8,53,udp,dns,56,140,1,84,1,224,2,normal,-
2595223533429145421,10.0.2.27,142.251.37.99,80,tcp,http,29414,1116,7,879,8,1995,15,normal,-
-6253230317198409404,10.0.2.27,8.8.8.8,53,udp,dns,33,232,1,86,1,318,2,normal,-
-2954716039786568813,10.0.2.27,8.8.8.8,53,udp,dns,55,117,1,87,1,204,2,normal,-
5646529013555987885,10.0.2.27,194.228.230.20,443,udp,-,241,7090,11,2477,7,9567,18,normal,-
-8105196182712006058,10.0.2.27,8.8.8.8,53,udp,dns,52,194,1,109,1,303,2,normal,-
-1429096901851742690,10.0.2.27,8.8.8.8,53,udp,dns,45,114,1,82,1,196,2,normal,-
-8211570271493845495,10.0.2.27,8.8.8.8,53,udp,dns,189,112,1,96,1,208,2,normal,-
-5839295447144177536,10.0.2.27,8.8.8.8,53,udp,dns,53,207,1,114,1,321,2,normal,-
2664656456804658220,10.0.2.27,8.8.8.8,53,udp,dns,38,110,1,82,1,192,2,normal,-
5109592213900667701,10.0.2.27,8.8.8.8,53,udp,dns,36,146,1,81,1,227,2,normal,-
-6845464621576186705,10.0.2.27,142.251.36.129,443,udp,-,1162,35880,46,5712,28,41592,74,normal,-
-1790273672459475406,10.0.2.27,8.8.8.8,53,udp,dns,75,204,1,92,1,296,2,normal,-
-5509552963983246875,10.0.2.27,8.8.8.8,53,udp,dns,37,135,1,84,1,219,2,normal,-
-1774647792490251698,10.0.2.27,8.8.8.8,53,udp,dns,61,148,1,92,1,240,2,normal,-
-8202298765065617946,10.0.2.27,8.8.8.8,53,udp,dns,45,132,1,83,1,215,2,normal,-
-7777486073064528805,10.0.2.27,142.251.37.97,443,udp,-,185,12429,11,2313,10,14742,21,normal,-
-6957162100004895697,10.0.2.27,8.8.8.8,53,udp,dns,49,104,1,88,1,192,2,normal,-
4633319198023549667,10.0.2.27,8.8.8.8,53,udp,dns,55,129,1,87,1,216,2,normal,-
8727223695499843730,10.0.2.27,8.8.8.8,53,udp,dns,93,206,1,95,1,301,2,normal,-
-2122945784420085317,10.0.2.27,8.8.8.8,53,udp,dns,64,148,1,92,1,240,2,normal,-
5967991207233077364,10.0.2.27,8.8.8.8,53,udp,dns,53,134,1,78,1,212,2,normal,-
-6124092402042643194,10.0.2.27,8.8.8.8,53,udp,dns,55,97,1,81,1,178,2,normal,-
-8783788384878091049,10.0.2.27,192.229.221.95,80,tcp,http,34488,7240,20,4546,21,11786,41,normal,-
-3267588053522907275,10.0.2.27,8.8.8.8,53,udp,dns,59,110,1,78,1,188,2,normal,-
7475057865626358913,10.0.2.27,8.8.8.8,53,udp,dns,53,157,1,84,1,241,2,normal,-
1860053179288580088,10.0.2.27,8.8.8.8,53,udp,dns,51,110,1,82,1,192,2,normal,-
-275481143416763966,10.0.2.27,8.8.8.8,53,udp,dns,52,156,1,83,1,239,2,normal,-
-1845121636877937419,10.0.2.27,8.8.8.8,53,udp,dns,55,156,1,83,1,239,2,normal,-
-5316413467097811954,10.0.2.27,8.8.8.8,53,udp,dns,57,185,1,104,1,289,2,normal,-
-7252780553604656743,10.0.2.27,8.8.8.8,53,udp,dns,52,208,1,85,1,293,2,normal,-
-5936096505554552232,10.0.2.27,8.8.8.8,53,udp,dns,54,117,1,85,1,202,2,normal,-
-8035835888081279597,10.0.2.27,8.8.8.8,53,udp,dns,61,158,1,94,1,252,2,normal,-
7981031591569816384,10.0.2.27,157.240.130.17,443,udp,-,422,7968,12,2033,7,10001,19,normal,-
6060535142796047327,10.0.2.27,8.8.8.8,53,udp,dns,51,117,1,101,1,218,2,normal,-
-6924365564491451565,10.0.2.27,8.8.8.8,53,udp,dns,59,234,1,84,1,318,2,normal,-
-5238847988529587319,10.0.2.27,8.8.8.8,53,udp,dns,42,150,1,96,1,246,2,normal,-
-2383168480301865124,10.0.2.27,8.8.8.8,53,udp,dns,78,152,1,88,1,240,2,normal,-
9020821832603750105,10.0.2.27,8.8.8.8,53,udp,dns,52,132,1,83,1,215,2,normal,-
7111616613756491385,10.0.2.27,8.8.8.8,53,udp,dns,61,230,1,88,1,318,2,normal,-
-6734202410127918731,10.0.2.27,8.8.8.8,53,udp,dns,56,98,1,82,1,180,2,normal,-
6029038049878372202,10.0.2.27,8.8.8.8,53,udp,dns,54,104,1,88,1,192,2,normal,-
7063981679482755546,10.0.2.27,8.8.8.8,53,udp,dns,44,272,1,106,1,378,2,normal,-
-3449677978689416900,10.0.2.27,8.8.8.8,53,udp,dns,48,146,1,81,1,227,2,normal,-
-2983439762330987295,10.0.2.27,142.251.37.102,443,udp,-,316,7972,12,2595,12,10567,24,normal,-
2756525832379630092,10.0.2.27,95.100.146.66,80,tcp,http,6980,4190,11,2360,12,6550,23,normal,-
7241902832688133449,10.0.2.27,8.8.8.8,53,udp,dns,42,107,1,91,1,198,2,normal,-
2740665263197989467,10.0.2.27,8.8.8.8,53,udp,dns,55,133,1,93,1,226,2,normal,-
6605763627676239720,10.0.2.27,8.8.8.8,53,udp,dns,52,148,1,92,1,240,2,normal,-
-5913560287596787110,10.0.2.27,8.8.8.8,53,udp,dns,51,263,1,116,1,379,2,normal,-
7808759454538623524,10.0.2.27,8.8.8.8,53,udp,dns,43,150,1,85,1,235,2,normal,-
-7759858772952382274,10.0.2.27,142.251.37.106,443,udp,-,610,41756,47,5342,25,47098,72,normal,-
235174591117000194,10.0.2.27,8.8.8.8,53,udp,dns,40,141,1,84,1,225,2,normal,-
2472793630864516524,10.0.2.27,8.8.8.8,53,udp,dns,45,138,1,82,1,220,2,normal,-
-6750933625194245230,10.0.2.27,77.75.76.30,443,tcp,-,36,60,1,128,2,188,3,normal,-
-7970182516710172429,10.0.2.27,8.8.8.8,53,udp,dns,47,126,1,86,1,212,2,normal,-
-1365271569226661755,10.0.2.27,8.8.8.8,53,udp,dns,48,136,1,91,1,227,2,normal,-
-734677485597423544,10.0.2.27,142.251.37.99,80,tcp,http,32971,1175,8,932,9,2107,17,normal,-
3061606564153479411,10.0.2.27,8.8.8.8,53,udp,dns,46,148,1,92,1,240,2,normal,-
6244384552079187661,10.0.2.27,34.107.221.82,80,tcp,http,34856,772,8,807,9,1579,17,normal,-
3947531048739782389,10.0.2.27,8.8.8.8,53,udp,dns,52,132,1,83,1,215,2,normal,-
9015265267160576365,10.0.2.27,8.8.8.8,53,udp,dns,41,176,1,94,1,270,2,normal,-
-6159917562696773801,10.0.2.27,8.8.8.8,53,udp,dns,47,138,1,86,1,224,2,normal,-
7014815555346116689,10.0.2.27,8.8.8.8,53,udp,dns,43,117,1,101,1,218,2,normal,-
1113004243068751749,10.0.2.27,8.8.8.8,53,udp,dns,186,148,1,92,1,240,2,normal,-
-4480192178319679462,10.0.2.27,8.8.8.8,53,udp,dns,47,117,1,101,1,218,2,normal,-
-1036727363296935434,10.0.2.27,8.8.8.8,53,udp,dns,57,116,1,88,1,204,2,normal,-
-9089972262680052321,10.0.2.27,8.8.8.8,53,udp,dns,51,129,1,101,1,230,2,normal,-
2082764506958970961,10.0.2.27,8.8.8.8,53,udp,dns,54,127,1,99,1,226,2,normal,-
5433268064878645064,10.0.2.27,8.8.8.8,53,udp,dns,44,130,1,114,1,244,2,normal,-
-409100312459693090,10.0.2.27,8.8.8.8,53,udp,dns,95,132,1,83,1,215,2,normal,-
8953120981074856568,10.0.2.27,157.240.30.27,443,udp,-,104,5735,10,1975,6,7710,16,normal,-
-1641762408726659017,10.0.2.27,179.184.204.17,443,udp,-,657,8054,13,2045,7,10099,20,normal,-
1102426846030326931,10.0.2.27,8.8.8.8,53,udp,dns,49,116,1,88,1,204,2,normal,-
-1671100998930579276,10.0.2.27,8.8.8.8,53,udp,dns,55,148,1,92,1,240,2,normal,-
-3913363926486989659,10.0.2.27,8.8.8.8,53,udp,dns,64,141,1,85,1,226,2,normal,-
-449192683516900878,10.0.2.27,157.240.249.8,443,udp,-,404,8375,13,2029,7,10404,20,normal,-
5501574651390888913,10.0.2.27,8.8.8.8,53,udp,dns,37,98,1,82,1,180,2,normal,-
-321570760477545943,10.0.2.27,8.8.8.8,53,udp,dns,36,153,1,89,1,242,2,normal,-
-7682607071831920674,10.0.2.27,8.8.8.8,53,udp,dns,47,184,1,85,1,269,2,normal,-
-5634669304019902789,10.0.2.27,8.8.8.8,53,udp,dns,46,129,1,101,1,230,2,normal,-
-6820156424421598098,10.0.2.27,8.8.8.8,53,udp,dns,54,145,1,93,1,238,2,normal,-
-3599136971992335955,10.0.2.27,8.8.8.8,53,udp,dns,37,216,1,96,1,312,2,normal,-
8213089905532929165,10.0.2.27,8.8.8.8,53,udp,dns,72,119,1,91,1,210,2,normal,-
-6853567424510052870,10.0.2.27,8.8.8.8,53,udp,dns,52,113,1,85,1,198,2,normal,-
1609119595938294985,10.0.2.27,8.8.8.8,53,udp,dns,51,148,1,92,1,240,2,normal,-
6417230659516617129,10.0.2.27,8.8.8.8,53,udp,dns,77,165,1,81,1,246,2,normal,-
-3499310229608536637,10.0.2.27,8.8.8.8,53,udp,dns,80,114,1,98,1,212,2,normal,-
-1365595864820374729,10.0.2.27,8.8.8.8,53,udp,dns,53,145,1,84,1,229,2,normal,-
-9062157861855168577,10.0.2.27,8.8.8.8,53,udp,dns,45,102,1,86,1,188,2,normal,-
5503642912925323560,10.0.2.27,8.8.8.8,53,udp,dns,49,234,1,100,1,334,2,normal,-
5340447715657132532,10.0.2.27,8.8.8.8,53,udp,dns,43,165,1,100,1,265,2,normal,-
3588059546413889018,10.0.2.27,157.240.234.1,443,udp,-,179,5650,9,1908,6,7558,15,normal,-
3008702436077906401,10.0.2.27,8.8.8.8,53,udp,dns,58,180,1,95,1,275,2,normal,-
4557405509096763489,10.0.2.27,8.8.8.8,53,udp,dns,53,148,1,92,1,240,2,normal,-
6769638896017677851,10.0.2.27,8.8.8.8,53,udp,dns,54,148,1,92,1,240,2,normal,-
2045799518050238903,10.0.2.27,8.8.8.8,53,udp,dns,62,124,1,89,1,213,2,normal,-
5199259804093352676,10.0.2.27,8.8.8.8,53,udp,dns,51,158,1,101,1,259,2,normal,-
8049798680462974731,10.0.2.27,142.251.37.99,80,tcp,http,30645,1932,9,1414,10,3346,19,normal,-
-5149041340913058597,10.0.2.27,8.8.8.8,53,udp,dns,63,121,1,93,1,214,2,normal,-
6220548528772844448,10.0.2.27,8.8.8.8,53,udp,dns,45,135,1,84,1,219,2,normal,-
5685754441529361399,10.0.2.27,8.8.8.8,53,udp,dns,58,170,1,88,1,258,2,normal,-
-8349809491871271076,10.0.2.27,8.8.8.8,53,udp,dns,43,189,1,116,1,305,2,normal,-
8449638602533156678,10.0.2.27,8.8.8.8,53,udp,dns,67,156,1,83,1,239,2,normal,-
4107161690146263647,10.0.2.27,8.8.8.8,53,udp,dns,40,166,1,82,1,248,2,normal,-
-3155498440035980795,10.0.2.27,77.75.77.195,443,tcp,-,117,60,1,128,2,188,3,normal,-
-2927035053218512164,10.0.2.27,8.8.8.8,53,udp,dns,40,148,1,91,1,239,2,normal,-
-3526579637101587475,10.0.2.27,192.229.221.95,80,tcp,http,34495,6943,20,4546,21,11489,41,normal,-
1318316505164293197,10.0.2.27,8.8.8.8,53,udp,dns,71,207,1,114,1,321,2,normal,-
